’м	їм, ним, а також мене, мені
’ме ліпше жити	буде, матиме можливість краще жити
’ні	мене, мені
Аби	Антибільшовицький народний фронт (Мехіко)
Абис	щоб
Аги	вигук невдоволення і розчарування
Агі́й	вигук розчарування, невдоволення, здивування, обурення
Адамашка	рід шовкової тканини; тут шовкова одежа
Ади́	ось, глянь, дивись, поглянь, бачиш
Адомашки	шовкова тканина
Аж	коли
Айбо	але
Айно	так (ствердження); тут — тільки
Аквавіточка	горілка (спотворене з лат.)
Аль	але
Альбо	або
Амбар	комора для зерна
Амбонія	амвон
Амбурк	Гамбург
Анцуг	костюм
Ар	0,01 гектара
Ара́пник	канчук, нагайка
Арештована гарматами	озброєна гарматами
Арша	вузька лопата для копання
Аршин	російська міра довжини, запозичена від татарів; десь 65 сантиметрів
Асесор	тут становий пристав
Атрамент	чорнило
А́фини	ягоди чорниці
Ачей	очевидно, мабуть, може
Аще	якщо
Ая́	так (ствердження), вживається в іронічному тоні
Ба	то (то туди, то сюди)
Баба-бранка	баба-повитуха
Бабити	приймати пологи
Ба́бка	пристрій, на якому клепають косу
Бавитися	бавитися, тратити час
Багака́ти	говорити розтягуючи слова (про священика); протяжно, по-церковному читати
Багати́р	багач
Багна	трава
Багнути	бажати
Бадання	обстеження
Ба́дати	обстежувати, оглядати хворого
Бадва	обидва
Баді́ка	сільський дядько
Бадя	сільський дядько
Базавлук	річка, права притока Дніпра; острів Базавлук (Чортомлик), на якому була Запорозька Січ
Базаринки	речі, куплені на базарі
Бай	бал, бенкет
Байбарак	сукняна куртка
Байда	великий шматок
Байдувати	байдикувати, гуляти, нічого не робити
Байка	невелике діло
Ба́йор	кольоровий пояс, сплетений з вовняних ниток
Байрак	невеликий ліс по степових ярах та балках
Ба́йфус (на байфус пустити)	розтратити, розтринькати
Байцува́ти	протравлювати
Бакскар	хвостовий вагон
Балагу́ра	візник з возом (підвода) для перевезення вантажів і людей на далекі відстані
Балган	лісорубська хатина круглої форми
Балта	сокира
Балуваний	розбещений (про дітей)
Балухатий	банькатий, лупатий
Баль	бенкет
Бальон	м’яч
Балюватися	бенкетувати
Балюка	коров’ячий кизяк
Бангов	вокзал
Банда	музика, оркестр
Бандури	австрійська прикордонна охорона, стражники
Бандурки	картопля, бараболя
Ба́нка	народна назва австрійської монети та купюри в дві крони
Банкар	працівник банку
Ба́нно	сумно, тужно
Ба́нта	поперечина
Банува́ти	тужити, сумувати, шкодувати, журитися
Банюр	глибоко розмитий берег річки
Бараба	лісоруб
Барабу́л(і, я)	картопля
Бараниця	укривало з кожушаного овечого хутра
Барбоси	тут жандарми і поліцаї
Барва	формений одяг (козацький чи солдатський)
Ба́рда	широка теслярська сокира
Бардз	дуже
Бардз(, о)	дуже
Бардзо	дуже
Бардичка	теслярська сокира
Барз	дуже
Барз(, е, о)	дуже
Барзе	дуже
Барзо	дуже
Барзо дивен	дуже дивний, дивовижний
Барило	бочонок
Баркан	дощатий тин
Барма	мундир
Барс	дуже
Барс би-м рад	дуже був би радий
Ба́ртка	гуцульський топірець
Бас	тут: наглядач, господар, підприємець, наставник
Басани	обшивка одежі для прикраси
Басурман	магометанин, зокрема татарин; вживалося і як лайливе слово
Басурманський	магометанин, зокрема татарин; вживалося і як лайливе слово
Батерія	батарея
Бати	1) батоги; 2) бити
Батюхна	батько
Батяр	хуліган
Бахур	хлопчик
Бацула	гаман з грішми
Бача	вівчар
Бачі	дядько
Бачік	дядько
Баша	паша
Баюра	велика, глибока калюжа
Бгачки́й	гнучкий
Бе(г, ґ)ар	кий
Бевка	пісна бідняцька страва-бовтанка
Бегарі	кий
Бедзатися	бігти, рятуючись від ґедзів (про худобу)
Без	бузок; через
Без ліс	через ліс
Безбогий	убогий
Безрога	свиня
Бекет	сторожа
Бендюх	кендюх, шлунок з худобини
Бербени́ця	висока вузька гуцульська діжечка для перевезень молочних продуктів на верховому коні, діжка для сиру
Бервено	дерево, колода
Бе́рдо	западина поміж гір, захаращена камінням і поваленими деревами
Бе́рівка	барило, бочечка
Бе́рня	колода
Берти	копати, рити
Беса́ги	дві з’єднані одним полотнищем торби, які перекидають через плече (на груди й спину); сакви; подвійна торба через плече
Бесажки	перекидні торби
Бесіда	розмова
Бесяги	така палиця, що коли скажеш “бий”, то б’є, а коли скажеш “досить”, так перестає
Бетяр	гультяй
Бефель	наказ
Би	аби, якби, щоб
Би’м	я, мене, а також — щоб я
Бизувати	довірити
Билень	ударна частина ціпа
Било́	стебло
Бинда	стрічка для підтримування волосся (дівочий головний убір), стьожка
Биндочка	стрічечка
Бирка	вівця
Биров	сільський староста
Бити	бути
Бицюга	худоба
Биця	худоба
Бичівня	підпрягання коней або волів, щоб витягнути важку фіру
Бичувати	припрягати до однієї пари волів чи коней ще одну або кілька попереду, коли важка поклажа
Бияк	бук, ударна частина ціпа
Бігар	палиця, батіг
Біди́ти	бідувати, терпіти біду, лихо, нещастя
Біжба	біг
Бізмаль	мабуть
Бізува́ти	ручатися, запевняти, бути в змозі, могти, бути спроможним
Бізуватися	братися за щось
Бізун	нагай
Біларапська земля	білоарабська; тут турецька
Білиця	білка
Білоз(і, о)р	ясноликий, мудрий
Білозір	ясноликий, мудрий
Білозор	ясноликий, мудрий
Більцева	з вибіленого полотна
Біляки	багата біла літня одежа з габи, білого сукна
Бір(о, у)ва́ти	здужати, бути спроможним, могти, спромагатися, витримувати
Біржа	фіакр, віз міського візника
Біскуп	єпіскоп
Біцьо	форма звертання жінки до чоловікового брата
Бічи	бігти
Бія́к, біячок	ударна частина ціпа, що використовувався при молотьбі
Благий	худий, слабкий
Блац	плац, майдан
Блехавий	блошивий
Блєховати	заковувати в залізні кайдани
Бляшаний	жерстяний
Бобкове	лаврове (листя)
Бовар	волячий пастух
Бовгар	пастух коло великої рогатої худоби
Бовдур	комин у печі
Бовкунець	один волик у запряжці
Бовт	крамниця
Бовташ	крамар
Богач	кукурудзяний корж, хлібина
Богрейдочка	весільна стрічка, часто паперова квітка
Боґанчі	черевики
Бодак	назва рослини
Бодниця	велика бочка
Боєв сє	боявся, лякався
Боїсько	тік
Боката	шматок чогось
Боксо́вий	хромовий (про шкіряне взуття)
Бола	лиха хвороба
Бомбетль	розсувна лава, яку використовували на ніч як ліжко
Бомбороси́ти	бурмотіти
Борбіль	перукар
Бо́рзо	скоро, швидко
Бори́шка	картопля
Борозда	скиба
Борснути	штовхнути
Бортак	дурень
Бо́рше	швидше
Боский	божий
Босорканя	відьма
Бости	бити рогами (про худобу)
Боськати	цілувати
Бота	палиця
Ботей	отара
Боцьок	лелека
Боцюн	лелека
Бочкарі	постоли
Бочкори	постоли
Боштан	гарбуз
Бравославець	хвалько, чванько
Брадрура	духовка
Бразалія	квітка
Бранзолє́т	браслет
Бра́нка	призов на військову службу, набір новобранців до війська, полонянка
Братанич	братів син
Брацця	братися
Бредці	ті, що бродять, або ходять вбрід
Брез	через
Брецман	гальмівний
Бри	фамільярне звертання до особи чоловічої статі
Брикар	перевізник на далекі відстані вантажів власними кіньми
Бриндюшки	проліски
Бриніти	грати
Бричка	візок
Бріх	живіт
Бровар	броварня, пивоварня
Бро́вник	пістолет системи браунінг
Бротєнка	гнуздечка
Бротцак	заплічний мішок, рюкзак
Бротянка	уздечка, гнуздечка
Брущен	кущі, зарості
Бубавий	покритий виразками й струпами
Бубнувати	бити в барабан
Будз	круглий гуцульський овечий сир
Буди́тися	коптитися
Буділарош	гаманець
Бужаниця	бужанина
Бужати	будити
Буза	напій з проса
Бузувати	карати, бити, лаяти
Бузьок	лелека
Бузя	уста
Бук	вид дерева; палиця, палюга, кий
Букарт	байстрюк
Буката	шматок чогось
Бука́тка	шматок
Букурі́я	ремінь для биття
Булава	коротка палиця з кулеподібним потовщенням на одному кінці; в старовину знак військової або адміністративної влади
Була́га	кий, дрючок
Булатнії саблі	шаблі з булату, спеціальної надзвичайно міцної сталі
Бульба	картопля
Бульбо́на	глибоке місце у річці
Буля	картопля
Бунда	верхня одежа, своєрідне суконне пальто
Бундурки	картопля
Бунчук	коротке древко з металевими прикрасами і кінським хвостом, знак військової влади отамана, гетьмана
Бург	замок, фортеця
Бурдей	землянка
Бурдюг	шкіряна торба, пухир
Буриння	картоплиння
Буритися	обурюватися
Бурка	буря
Буркована	брукована
Бурлак	бездомний, бідний, найманий робітник за часів кріпацтва
Бурлак(, а)	бездомний, бідний, найманий робітник за часів кріпацтва
Бурлака	бездомний, бідний, найманий робітник за часів кріпацтва
Бурок	замок, фортеця
Бурта́вий	дуплистий, порохнявий
Бурунька	люлька; тут люлька, виточена з березового кореня
Бусьок	лелека
Бутей	отара
Бути	черевики
Бу́тин	лісорозробка
Бутина́р	лісоруб
Бутіти	ревти, як реве бугай
Бухнай	черевань
Бу́хня	напіврозвалена халупа
Буцигарня	камера для попереднього ув’язнення в селі
Бучара	палиця, палюга
Бучо́к	паличка
В ворот	біля воріт
В гір	в гори
В кузьмірки грати	в схованки грати
В набор	тут: в борг
В сашині	в корчах, осоці
В тяжі	вагітна
В’єдно	вкупі, разом
В’ни	вони
В’язанка	в’язка
В’язд	в’язниця
В’язові постоли	взуття з лика в’язу
Вабря	дерев’яна балка
Вавка	виразка
Вавки	ранки
Вага	важіль, підойма
Ваган	посудина, в якій розтирають сало з цибулею для борщу; ночви; довгаста дерев’яна миска для їжі
Вагівня	важіль, підойма
Ваговий дрюк	дрюк, яким піднімають воза, щоб підмазати колеса
Ваґаш	ділянка лісу для вирубки
Вадаска	полювання
Вадитися	сваритися
Вадний	гарний
Важатися	бавитися, гратися
Важити	замишляти, мати на увазі, щось замірятися зробити
Важник	важіль, підойма
Важниця	підставка під ваговий дрюк
Вайлакува́ти	бурлакувати
Вакар	коров’ячий пастух
Вакелия	трут, гриб на дереві
Вакувати	гаяти час, нічого не робити
Вал	грубі, товсті нитки з паклі, товсті нитки з клоччя; тканина, виткана з грубої пряжі з клоччя
Валав	село
Валал	село, місто
Валасаться	волочитися
Валастас	збори, на яких обирали короля
Валашка	сокира
Валівцева	зроблена з валу
Валов	корито для пійла, видовбане із колоди
Валова	село
Валовина	грубі, товсті нитки з паклі
Валови́ця	мотуз, вірьовка
Валув	корито для пійла, видовбане із колоди
Валюх	лінюх
Валяв	село
Ванда	гарапник, довгий батіг
Вандрувати	мандрувати
Вантір	комірчина
Ваньтір	комірчина
Вар	слово для підсилення наступного слова
Вара	геть!
Варгатий	губатий
Вари́	уживається для підсилення запитання
Вариш	місто
Варіха	велика дерев’яна ложка
Варовати	берегтися, стерегтися
Варош	місто
Вартувати	бути вартим
Варуватися	стерегтися, остерігатися
Варцаба	одвірок
Ва́ря	варена страва
Ва́саг	верхня частина воза, саней; ящик
Васпане	милостивий пане
Ватаг	отаман, керівник, старший пастух
Вата́га	осавул, панський наглядач
Ватаже́л	дружба молодого на весіллі
Ва́тра	багаття, вогнище, вогонь
Ва́трище	місце, де горіла ватра
Ватрушка	російський коржик з сиром
Вахи	одяг, лахміття, драна бідна одежа
Вахцимбра	вартівня
Ва́цкати	ляпати, ляскати
Вашар	ярмарок, базар
Вашець	ваша милість
Вба	обидва
Вбертати	обертати
Вби	якби, щоб
Вбирати	одягати
Вби́тися	розбитися
Вбід	обід
Вбоє	обоє
Вбриндувати	вдягнути, нарядити
Вважати	керувати конем при допомозі віжок
Вгі́дний	працьовитий і добрий
Вгорну́тися	одягнутись
Вго́ртина	верхній одяг
Вда́тися	сподобатись
Вдивити	придивитися
Вдоволь	досхочу, вдосталь
Вдоли́ну	додолу, вниз
Вдяга	одежа
Ве́вкати	уривчасто пищати
Ведле	біля
Векелия	губка на стовбурі дерева
Векша	більша
Великий луг, луг	назва плавнів у пониззі Дніпра, де були землі Запорозької Січі
Велкі	великі
Велька	велика
Велький	великий
Вельо	багато
Вепер	кабан
Ве́р	кинув
Вер(е, и́)́чи	кинути, викинути (я вержу, ти вержеш, я вер, ти верла)
Вер(е́, і́)тка	ряднинка, килимок, рядно; ряденце
Вера	мабуть, правда, дійсно
Верг	кинув
Вергтися	кинути собою
Верені	рядна
Верета	домоткана ковдра, рядно, мішковина; тут бідна одежа з мішковини
Веречи	кинути
Ве́рла	кинула
Ве́рлася	злякалася
Верлося	кинулося, кинуло собою
Вермівка	премила
Верстик	ровесник, ровесниця
Верстниця	ровесник, ровесниця
Ве́рся	злякався
Вертіп	заболочена долина
Ве́рчи	кинути, викинути, кидати
Веснува́ти	вести весняні посівні роботи
Веце	більше
Вецей	більше
Веций	більше
Вечеря́ти	вечоріти, смеркати
Ве́шка	верша, сплетена з лози риболовна снасть
Взаран	завтра
Вздріти	побачити
Взоун	Великий збір об’єднаних українських націоналістів
Взун	Великий збір українських націоналістів
Вибагла	вигадала
Вибадати	вивчити, обстежити
Вибер	вибери
Вибранчик	рекрут
Вибутніти	спорохнявіти
Вив’юрка	білка
Виверла	викинула
Вивертеть	повалене дерево
Виверть	вивернуте з коренем дерево
Вивід	церковний обряд, через який проходила жінка після народження дитини
Вивірка	білка
Вигляд	вікно
Ви́гулити	виманити звідкись
Виґутнути	виштовхнути
Видати дорогу	зробити вигляд, що кудись поїхав, та й нікуди не їхати
Видить ми ся	бачу я, бачиться мені, мені здається
Ви́діти	бачити
Визір	вікно
Ви́знати	вивідати, довідатися
Визор	вікно
Вийка	оберемок
Викартати	виграти в карти
Ви́кіцкати	вичистити (переважно хлів від гною)
Ви́кішити	виростити
Виклочити	висидіти з яєць
Викоренувати	викорчувати
Ви́кутати	вигодувати
Виладувати	вивантажити
Вилапати	виловити
Виложення	вилоги; тут: військові відзнаки на комірі
Виманить	смалить
Вимикнути	вискубнути
Вимівка	відмовка
Вимітувати	викидати
Вимова	умова
Вимте	вийміть
Винниця	виноградник
Вино	тут: виноград
Винув	вийняв
Виповіда́ти	оголошувати
Виправляти	виряджати
Випудити	вигнати страхом
Ви́пуцуваний	вичищений до блиску
Ви́пуцувати	вичистити до блиску
Виргани	органи
Виспа	острів
Виставати	вийти, піти, минути
Вистати	вийти, піти, минути
Витачати (вози)	викочувати із сарая
Витки	звідки
Витоварювати	виганяти на пасовисько
Виточати (вози)	викочувати із сарая
Виховаш	виховуєш
Виходок	вбиральня
Вицвічений	вимуштруваний, навчений
Вицьофаритися	гарно вбратися
Вишоритися	привести себе до належного вигляду
Вищикати	вищипувати, виривати
Вівців	овець
Віграни	органи
Від’вам	до вас
Від’кугутови	до півня
Від’нему	до нього
Від’собі	до себе
Від’тобі	до тебе
Від’тому	до того (когось)
Віда́в	мабуть
Віда́й	мабуть, напевно
Відбиває корова	запускається корова
Відбор (до відбору йдучи)	набір у солдати
Відвінувати	наділити приданим
Відві́т	відповідь
Відгу́лювати	манячи відводити в інше місце
Віддати на виданнє	видати заміж
Віддати рік	рік не одружуватися після смерті чоловіка або дружини
Віддатися	вийти заміж
Віде́й	мабуть
Відзу	бачу
Відка́зувати	заповідати, залишати у спадок
Відклонитися	попрощатися
Відков	звідкіля; тут — з чого
Відмастити	набити
Відноситися	ставитися
Відпа́сти	загубити пасучи
Відсипа́ти	відливати, приводити до тями
Відтворя́ти	відчиняти
Відтика	відти
Відтогди́	відтоді, від того часу
Ві́дци	звідси
Відчути́тися	очуняти
Відщитати	відрахувати
Війнувати	воювати
Війт	сільський або волосний староста чи старшина
Війя	дишло у воловому возі
Вільгла	волога
Він, цур йому	<a href="https://proridne.net/Українська міфологія/Чорт.html">чорт</a>
Віни	рослини
Вінирати	виринати
Ві́но	посаг, придане, майно, одержуване нареченим або нареченою при одруженні
Вінувати	давати посаг
Вінчува́ти	віншувати, вітати
Вір’яночка	свашка
Вірла	орлиця
Вірлята	орлята
Віт	війт, сільський староста
Вітова	війтова
Віхтовати	харчувати
Ві́шка	кропило
Віщівник	віщун, провидець, ворожжбит
Віщу́(н, к)	ворожбит, провидець, чарівник
Вклякати	ставати на коліна
Вку́тати	знищити ворога
Влапити	вхопити в лапи
Влію	волію
Влойки	воли
Влони	торік
Влякли	злякалися
Вманти́ти	обдурити
Вмісті	разом
Вна	вона
Вначалі	спочатку
Вни	вони
Внімательно	уважно
Во мені	про мене
Воброста	обростає
Вовоньки	воли
Водни	вдень
Водно́	весь час, постійно
Воєв(о, у)дство	адміністративна одиниця території Польщі
Воєвода	тут: перший нажатий сніп на ниві
Воємскі	військовий
Вожжі	віжки
Возовий	проїжджий возом, а також податок за проїзд возом
Вой войовати	війну воювати
Во́йна	войовничий, хоробрий, мужній
Во́йний	войовничий, хоробрий, мужній
Воко	міра рідини (1-1, 5 л )
Воковита	горілка
Вокоман	економ
Вола	кличе
Волайце	звіть
Воле	зоб
Волитися	тут бажати чогось
Волічка	кольорові вовняні нитки для вишивання або ткання килимів
Волічки ремінні	зав’язки
Волічкувати	волочити
Волки	воли, волики
Волови́ця	мотуз, вірьовка, налигач, мотузок
Волові́д	мотуз, вірьовка, налигач, мотузок, товстий мотуз
Воло́ка	мотузок, яким зав’язують постоли, обв’язують онучі
Волоки валові	зав’язки з валу від постолів, лаптів або личаків
Волоньки	воли
Волоський	молдавський
Волох	румун
Волшебстувавати	чаклувати
Воляр	пастух волів
Вон	надвір
Воняти	смердіти
Вообще	взагалі
Воргани	органи
Вори́на	жердина, загорожа з жердини, жердина в плоті, жердина з огорожі
Вориння	жердини для огорожі
Ворожільник	ворожбит
Ворожіля	ворожка
Во́рок	мішок
Ворох	купа
Вочі	очі
Вошкуватися	шукати на голові вошей
Впихати	товкти в ступі
Впіха́ла	тут: накидала, надавала
Вположи́тися	отелитись
Впомку	на пам’ять
Впудитися	злякатися
Вра́з	весь час, постійно, разом, одночасно
Врац се	вернися
Врел	вельми
Врем(’, н)я	час
Вроді	ніби
Всев	усією
Всенький	цілий
Вси́літи	увійти в силу, набратися сили
Всігда	завжди
Вскорості	незабаром
Вспіти	встигнути
Вспішитися	поспішати, швидко щось робити
Встарати	придбати
Встрі́тити	зустріти
Всум	Виховна спільнота української молоді
Всьо	все
Всяди	всюди
Втворіть	відчиніть, відкрийте
Втворя́ти	відчиняти
Втемніти	осліпнути
Втерти	засвітити (сірник)
Втім’я́тися	набридати
Втіпенити	сильно вдарити
Втірочки	торочки; бахрома в рушниках
Втішитися	зрадіти
Втішний	радий
Втолити	вгамувати
Втумани́ти	обдурити
Втямити	помітити, угледіти
Вуботирі	ті, що везуть катафалк
Ву́гол	кут, ріг (вулиці, будинку)
Вудиння	огудиння
Вужи́ще	товста вірьовка, шнур, мотуз
Вужуватися	звиватися, як вуж
Ву́йко	дядько
Вуйма	плетений з вовни шнур
Ву́йна	дядина, тітка
Ву́йночка	тітонька
Вулки	воли
Вунну	всередину
Вуо	Волинське українське об’єднання
Вурда	низькосортний сир, виварений з сироватки овечого молока; підігріте квасне овече молоко
Вучей	очей
Вфасувати	припасувати
Вцалє	зовсім
Вцюркуватися	мочитися під себе
Вчини́ти	понароджувати, народити
Вчини́тися	опинитися; народитися
Вчуняти	одужати
Вшак	втім
Вше	завжди
Вшелиякий	всякий
Вши	всі
Вшистко	все
Вшитки	всі
Вшитко	все
Вшиток	весь, увесь
Вшіткі	усі
Вшпінька́тися	застебнутися
Вщолочати	встоятися
Габа	дороге біле турецьке сукно
Габар(у) не мати	нічим не журитися
Габу́чити	зупинятися, як вода, що натрапила на перешкоду
Гавз (гауз)	дім
Гавран	ворон
Гадвабний	шовковий, єдвабний
Гадкувати	стерегти
Гадю́чка	молода смерічка
Гаж	аж
Газдик	господар
Газдиненька	господинонька
Газдиня	господиня
Газдівливий	хазяйновитий
Газдувати	хазяйнувати
Гай	вживається для позначення швидкого розвитку подій, вигук для прискорення дії
Гайдай	пастух
Гайдамака	в XVII—XVIII ст. козак, селянин — повстанець проти соціального і національно-релігійного гніту
Гайдар	вівчар
Гайдарка	вівчарська палиця
Гайдей	погонич коло худоби
Гайдук, гайдуки	в XVI—XVIII ст. солдати придвірного війська феодалів; солдати-найманці, а також карателі
Гайник	лісник
Гайнувати	знищувати
Гайовий	лісник
Гайстер	лелека
Гайта	вигук візника на коней
Гайтове	лісові сторожі
Га́йцер	кочегар
Гайцува́ти	кочегарити
Гайшта	сумка
Галамбець	густе вариво з житньої муки
Гала́набалу	навмання
Гала́світа	по цілому світу
Галера	каторга, велике гребне судно в середньовічній Туреччині, на якому гребцями були невільники, зокрема слов’янські, прикуті ланцюгами до лав
Галє́рія	довгий балкон уздовж будинку
Гали	литки, ноги
Галич	зграї галок або ворон
Галійщина	Галичина
Гальба	пів, половина (літра пива)
Гальдовник	чарівник
Гальтувати	зупиняти
Гамба́р	комора (окрема споруда), комора для зерна
Гамбараш	голосна сварка
Гамбіті	губи
Гамер	дрібна монета
Ган	заїзд для ночівлі з возом і кіньми, заїжджий двір
Га́на	недолік, вада
Гандибурка	картопля
Га́нити	осуджувати, виражати незадоволення
Ганц	цілком, повністю
Ганьбитися	соромитися
Гараба	віз
Га́разд	порядок, лад
Гара́пник	канчук, нагайка
Гаратати	бити, трощити
Гардша	краща
Гарман	тік, де молотять хліб
Гарнець	дерев’яна міра на зерно, глечик
Гарувати	тяжко працювати на своєму господарстві
Гарцувати	брикати
Гатар	земля одного села від межі до межі
Гаті	домоткані штани
Гаткувати	доглядати, охороняти
Га́чі	штани
Гачник	очкур
Гаш	аж
Гварити	говорити
Гвер	гвинтівка, зброя, карабін
Гвирка	оружно, зброєю
Гвізд	цвях
Гвоздь	цвях
Гев	тут, сюди
Гедзитися	тікати, рятуючись від кусючих комах (про худобу)
Ге́зд(е, и, о)	ось тут
Гей	як, ніби; вживається для підсилення дії; як (при порівнянні)
Ге́йби	наче, немов, ніби, як
Гейданка	колиска
Гейдати	колисати
Гелетка	бочка
Гемби	губи
Ге́нд(е, и)	он там
Гербата	напій; в сучасній польській мові гербата означає чай
Гертанки	горло
Гет	геть
Ге́ци	погані жарти
Ги́бель	рубанок
Гиби	як, ніби
Гий	як
Гишечки	зменш від гишки (гижки) — холодець, драглі із ніжок, ніжки в холодці; ноги, ніжки; тут дрібні кісточки
Гі	вигук здивування
Гій	вигук обурення
Гі́кати	сварити
Гілетка	міра
Гіля́	дерев’яна посудина, в яку чабани доїли овець
Гін	українська старовинна народна міра довжини
Гінджибаба	відьма
Гладу́н	глек
Гладунець	глечик
Гладуш	глек
Глаза	очі
Глас	голос
Глиг	глід
Гли́жя	глід
Глип	зирк
Гли́пнути	зиркнути, подивитися, глянути
Глипнутися	озирнутися
Глиця	тут стовпчик у дерев’яній кладці (через річку) або в огорожі
Глі́бко	<a href="https://proridne.net/Українська міфологія/Чорт.html">чорт</a>
Гліг	глід;шеренга
Глітно	тісно від великої кількості людей
Глоги́	глід
Глони	торік
Глота́	ті́снява (ти́снява) від великого скупчення людей
Глоти́тися	тиснутися
Глупота	дурість
Глядати	шукати
Гляді́ти	шукати
Гміна	волосне правління
Гнеска	сьогодні
Гнесь	сьогодні
Гнет	скоро
Гнилиці	грушки
Гнів положити	розгніватися
Го	його
Говіння	піст
Годвіз	одвіз
Годенки	вечорниці
Годзінар	годинникар
Годин	один
Годинка	годинник
Годи́тися	торгуватися, вести переговори, домовлятися
Годний	гарний, а також добрий, здоровий
Годованка	прийомна дочка
Гозди	ось тут
Гойкати	вигукувати, кликати, кричати, гукати
Гойний	гарний, достойний, щедрий
Голдувати	давати данину, бути залежним від поборів
Голиця	місце, розчищене від дерев, лісу
Голодриґаш	голодранець
Голомороззя	ожеледиця
Голота	біднота, бідняки
Голубець	гуцульський танцювальний крок
Гомость	священик
Гонорова служба	знатна служба з великим чином і доброю оплатою
Гора	горище
Горд(і, о, у)в	бочка, діжка
Гординський шлях	ординський шлях, шлях, вибитий татарською ордою під час спустошувальних наскоків на українські землі
Горі́	вгору
Горівка	горілка
Горі-долу	вверх-вниз
Горн	комин у хаті
Горнец	горшок (посуда)
Горнець	глечик
Городити	плести (кошик)
Горо́дник	заступ, лопата для копання землі, рискаль
Горохляний	в горошинах
Горці	горнята
Горшкодрай	мандрівний гончар, що ремонтував горщики
Го́рщя	горня, горнятко
Горько	гірко
Госовкнула	посковзнулась
Госпо́да	власний будинок, господарство
Господар волоський	правитель, князь молдавський
Господарка	господарство
Гостинець	битий шлях
Гостити	переживати якісь пригоди
Гось	ось
Гота́р	межа між землями двох сусідніх сіл
Го́фа	подвір’я
Гочкур	шнурок або ремінь для підперізування штанів
Гояна	гей
Гра́б(’, і)я	граф
Гра́бля	титуловане панство
Гради	балки вгорі вздовж стін у курних хатах; жердки в хатах при стінах
Границя	кордон
Грань	жар із перегорілого палива
Грап	граф
Грати	танцювати
Гребі́нний	зроблений з грубого домотканого полотна
Грейцар	монета
Грейцер	дрібна австро-угорська монета
Грєди	балки або жердки вгорі при стінах у курній хаті
Гриза	турбота
Гризтися	переживати, мати клопіт, журитися, мати гризоту
Гримоти	гуркіт
Грис	грубі висівки жита, якими годують свиней
Грінер блазен	лайливе прізвисько емігрантів
Грі́нка	скибка (хліба)
Грозен	гроно винограду, кетяг
Грозно	гроно
Гру́ба	піч; вагітна
Гру́бий	дорогий, панський
Груз	грязюка, розкисла глина
Грузити	вантажити
Грузь	болото на дорозі, болото під ногами, грязюка
Грузьки́й	замащений болотом, забруднений болотом
Грунок	пагорб
Груночок	горбочок
Гря́ди	балки вгорі понад стінами чи при стінах у курній хаті, на яких сушать дрова
Гряна неділя	зелена (русальна) неділя
Губи	гриби
Губи́ти	вбивати
Гудак	музика, скрипаль, музикант
Гудаки, гудачки	музиканти
Гудець	музика
Гудз	вузол на вірьовці
Гудьба	юрба людей з музиками
Гужі	ремінь для прикріплення голоблі до хомута
Гужки	віжки
Гужовка	мотузка я лози
Гужтру́д	примусова безоплатна праця, коли селян під страхом тюремного ув’язнення (більшовицькі власті виганяли рубати і возити своїми кіньми карпатський ліс)
Гузи́ця	сідниці, зад
Гузно	зад (анатом.)
Гу́зок	клунок
Гук	пугач
Гули́ти	вабити, приваблювати; манити
Гулька	гілка
Гулюкати	вигукувати презирливо комусь услід
Гуляр	комір
Гуляти	танцювати
Гуляти (в степу, на долині)	воювати, відбивати напад ворогів
Гум	розум
Гумен	ігумен
Гуменний	панський наглядач за роботою кріпаків або наймитів на току
Гумно	клуня, стодоля
Гунгар	угорець
Гунм	Група української національної молоді
Гунца	воло
Гунцват	волоцюга
Гунцут	негідник
Гунч	гончак
Гура	купа, гора, сніговий замет
Гурале	горець
Гурба	юрба
Гурок	огірок
Гу́ска	грудка
Гуслі	скрипка
Гуслянка	молочний продукт, поживний кисляк, який дуже довго зберігається
Гусник	гущавина
Густи	грати
Гутіти	гудіти, стугоніти
Гуто́рити	розмовляти
Гухнути	хукнути
Ґазда	господар, хазяїн, а також селянин
Ґазди́ня	господиня, хазяйка
Ґаздівка	господарство
Ґаздівство	господарство
Ґаздува́ти	господарювати, хазяйнувати
Ґайдати	грати на сопілці
Ґайдичка	сопілка
Ґайтувати	підганяти
Ґамба	уста
Ґандж	недолік, дефект, вада
Ґанчувати	знаходити в комусь ваду і критикувати за це
Ґарадич	сходи в будинку
Ґа́рнець	дерев’яна посудина; міра об’єму рідини і сипких продуктів
Ґа́рчик	дерев’яна посудина, міра для сипких продуктів
Ґатри	тартак, пилорама
Ґвавт	галас
Ґвавтува́ти	кричати: Ґвалт!, голосно кричати
Ґвер	гвинтівка, карабін
Ґедзитися	брикати, тікаючи від кусючих комах (про худобу)
Ґедзкатися	брикати, тікаючи від ґедзів (про худобу); відволікатися
Ґеле́тка	бочечка місткістю 25 літрів
Ґелетя	бочечка
Ґешефт	вигідна бізнесова оборудка, торг, прибуток
Ґирли́г (гирлиг)	довга чабанська палиця з гачком на кінці
Ґлід	шеренга
Ґльоцнути	шубовснути
Ґміна	сільська управа за Польщі
Ґоспода́рка (господарка)	господарство
Ґра́жда, гра́жда	велика господарська будівля в сільській садибі, загорода для худоби або коней, обгороджене господарське подвір’я
Ґра́лі	вила
Ґрасувати	витоптувати
Ґре́йцар	мідна розмінна монета за Австрії
Ґрис	висівки
Ґрунт	приватне селянське землеволодіння
Ґрунь	гора, не покрита лісом
Ґуґлик	грудка, зліплена зі смоли, клоччя й лою
Ґу́ґля	довга жіноча свита червоного чи білого кольору
Ґуґолник	капюшон
Ґудз	вузол; сучок
Ґудзок	вузлик
Ґудзувати	силувати
Д’вечеру	у надвечірній час
Д’них	від них
Дагди	десь
Даже	навіть
Дакий	якийсь
Даколи	інколи, коли-не-коли
Дакус	доки
Далекогляд	бінокль
Дампшифа	пароплав
Дамфіша	пароплав
Дамшиф	пароплав
Да́нець	танець
Данці	танці
Данцювати	танцювати
Дарабчик	шматочок
Дарок	подарунок
Дати на бу́бон	заплатити глашатаєві (тому, хто оповіщає про щось), щоб той, ходячи містом, бив у бубон та оголошував пошук зниклої людини
Дах	хлів, прибудова для овець, утворена продовженням мало не до землі даху з одного боку хати
Дахто	щось
Дашто	дещо, щось
Двигнути	підняти
Двір	палац, панський дім
Дев’ятини	дев’ять днів після смерті людини
Дедьо	батько
Де́ка	десять грамів; укривало
Декуватися	орієнтуватися
Деліка́тний	дуже гарний
Деліка́тно	дуже гарно
Демено	стерно, руль
Денцівка	вид гуцульської сопілки
Деньки́	поденні роботи
Денько́ві роботи	поденні роботи
Дереви́ще	труна
Дереш	екзекуція, покарання
Де́ржало	держак
Держено	держак
Дес	де
Десяцький	тут помічник старости чи старшини, який виконував поліцейські обов’язки
Десячана	полотняна
Деца	100 грамів рідини
Дєдьо	тато
Дє́дя	тато
Дєйствітелно	дійсно
Джвенді́ти	набридати розмовами
Джвенливий	сварливий
Джеган	кирка
Джерелиця	чиста вода з джерела
Джє́ху дати	злякатися, жахнутися
Джинджуристий	чепурний
Джи́рґа	гуцульське вовняне укривало на ліжко
Джмуркати	моргати;
Джур	їжа з розведеної водою вівсяної муки і конопляної олії, кисла страва з квасолі, картоплі й часнику
Джура	1) козацький слуга, помічник, товариш, довірена особа військового керівника; 2) джур; страва з непросіяної вівсяної муки без приправи; бідна страва
Джури́ни	шкварки
Джуря́к	шкварка
Дзбати	дбати, турбуватися
Дзгоравий	дірявий
Дзевечка	дівчина
Дзер	сироватка
Дзига	тут коловорот колодязя
Дзиґар	годинник; цигарка
Дзиґа́рок	годинник
Дзи́ґом	неприязно
Дзіндзіровий	чепурний, елегантний
Дзуґати	штурхати
Дзуркати	брязкати
Дзьо́бня	гуцульська вовняна торба
Дзьора	дірка
Дзюравий	дірявий
Дзюри	дірки
Дзяд	дід (чужий)
Дзяма	суп
Диби на ноги	кайдани для ніг з великої колоди
Диван	килим
Дивіці	дивиться
Дик	дикий кабан
Дикун	дикий кабан
Дилина	товста дошка в підлозі
Дили́ння	(збірн.) грубі дошки, бруси, балки
Димка	смугаста спідниця
Димник	отвір у стелі для виходу диму в давніх курних хатах
Динь	гарбуз
Диня	гарбуз
Дипо, дипоя	вокзал
Ді	до
Діваця	діватися, подітися
Дівер	брат чоловіка
Дід	старець, жебрак
Дідвиці	бедра
Ді́дич	поміщик, великий землевласник, пан
Дідко	чорт
Діднина	дідівська й батьківська спадщина
Дідуньо	дід
Дідько	<a href="https://proridne.net/Українська міфологія/Чорт.html">чорт</a>
Дідьчий	чортячий
Дідьчота	<a href="https://proridne.net/Українська міфологія/Чорт.html">чорти</a>, чортівня
Діл	гірський хребет
Ділений	готовий поділитися з ближнім
Ділетка	міра (четверик) для зерна
Дінго	річ, предмет
Ді́нниця	огорожа з накладених у ряд зрубаних смерічок
Дітвак	дитина
Діточий	дитячий
Днесь	сьогодні
Днешній	сьогоднішній, нинішній
Днєш	нині
Днина	день
Днись	сьогодні
Днище	дерев’яна дощечка, на одному кінці якої сидить пряха, а на другому кріпиться гребінь або куделя; вистругана дошка, донце з пазом на потовщеному кінці, куди вставляють гребінь
До ’статного	до останнього, всі до єдиного
До маси	до канцелярії
До рахунку	до волості, а також до числа
Добиток	розум
Добізовна	напевно
Добрезні	добрячі
Добритися	подобатися
Довг	борг
Довганя	сорочка з козячої шкіри
Довжанка	довга полотняна сорочка
Доганяти	знаходити на комусь «догану», тобто якусь ваду, недолік
Догварятися	домовлятися
Доґаздоватися	дохазяйнуватися
Дозирати	доглядати
Дозор	нагляд
Доїсти	надокучити, набриднути
Дойдж	дощ
Доказати	довести
Докивати	зачіпати
Докинутися	доторкнутися
Докіми́ти	додуматись
Доколи́	до яких пір, до якого часу
Докоряти	набридати небажаними розмовами й причіпками
Докус	повністю, цілком, зовсім
Доли́на	низ
Долі	додолу, вниз
Долів	униз, додолу
Долівлиць	донизу лицем
Доліниць	вниз лицем
Долу	вниз, додолу
Домарити	доглядати дім у відсутність господарів
Домарі	домохазяї; тут селяни
Домі	додому
Домів	додому
Доміство	домашнє господарство
Домов	додому
Домов ся вернули	повернулися додому
Дому	додому
Допахати	доорати
Допетрати	зрозуміти
Допра	тюрма
Дораз	зараз, зразу
Дорожити	подорожувати
Дос	досить, багато
До́ста	досить, достатньо, багато
Доходуча дівчина	дівчина на віданні
Дохожалий	дорослий
Дочинє́ня	мати неприємну справу з кимось
Драб	розбійник, голодранець, розбишака, тут бідняк
Драбу́га	бандюга
Драга	дорога
Дражечка	дорога
Дражічка	дорога
Дражка	дорога, доріжка
Драники	оладки з картоплі
Дранкогу́з	голодранець
Дранкогу́зка	голодранка
Дранти́вий	обдертий; подертий, дірявий
Дра́нтя	дуже зношений і подертий одяг
Драпака давати	втікати
Драча	колючі чагарі
Драчка	битва
Драчник	колючі кущі
Драччя	колючі кущі
Дрема	той, що багато спить
Дрептати	ступати дрібно
Дривітня	колода, до якої рубають дрова
Дриляти	викидати геть
Дрин	дрючок для биття
Дробіцькати	тупотіти
Дровітільник	колода, на якій рубають дрова
Дрогаля́йник	волоцюга
Дрогове	подорожнє, податок за користування дорогами, що проходили через державні або поміщицькі землі
Друбля	дрібнота (кури, гуси, качки)
Друбні	дрібні
Друлити	кинути (звалити)
Дуб	човен, видовбаний з цілого стовбура дерева, зокрема з дуба
Дуба піти	шкереберть полетіти
Дубати	тупати
Дубельтовий	подвійний
Дубельто́во	подвійно
Дубина	довбня
Дубля	дубина, дубовий ліс
Дуга	пристрій для запрягання коня в однокінну упряжку
Дудев	забур’янене місце
Дудніти	стугоніти
Дука	багатій
Дукат	червінець, старовинна золота монета; тут золотий червінець
Дукати	гроші
Дукач	багатій
Дуки-сребраники	багачі, вельможі
Дукса	прочуханка
Дула бити	бити по потилиці, бити взаший
Дулі	сорт груш
Дульки	сорт груш
Дуля	сорт груші (народна назва); груша (плід)
Дун	Дружина українських націоналістів
Дунай	будь-яка річка
Дуні́ти	стугоніти
Дуркати	галасувати, стукати, щоб впустили
Дусити в руках	тут міцно тримати в руках, душити
Дутка	монета
Дуфати	надіятися, сподіватися, в цісаря дуфати — надіятися на вислугу в цісаря
Дуфати в щось	мати до чогось великий нахил
Духати	швидко летіти
Духвати	надіятися, сподіватися, в цісаря духвати — надіятися на вислугу в цісаря
Ду́хом	дуже швидко
Дуча	діра
Дучка	ямка, дірочка, дірка, нірка, дірка, ямка
Душити	скинути
Дц	Державний центр
Дьоргати	сіпати
Дюгати	штурхати
Дю́ґнути	штурхнути
Дюравий	дірявий
Дюхати	штурхати
Дядьо	тато
Дя́дя	тато, батько
Дяку мати	мати бажання, мати охоту
Дякуля	дячиха
Евакувація	евакуація
Едеман	вид шовкової тканини
Ей йа лем ти ме	ой тільки ти мене
Екзекутива	Виконавчий орган, виконавча влада
Екзерцірка	муштра
Екзецирка	муштра
Екзецірка	муштра
Есаул	осавула, поміщицький прикажчик, наглядач за кріпаками або наймитами, а також офіцерський чин у козацькому війську
Єгда	коли
Єгомос(т, ц)ь	священик
Єгомосець	священик
Єгомость	піп, ксьондз
Єдвабна	шовкова
Єдвабний	шовковий
Єднати	тут піймати і знищити
Єдногу	одного
Єдомашки	шовкова тканина
Єк	як
Єкось	якось
Єкус	якусь, якась
Єли казати	стали казати, говорити
Єлі	ледве
Єнчий	інший
Єпітрахіль	покривало, яким піп покриває голову віруючого під час сповіді
Єрс	Європейська рада свободи
Єс	є
Єси	є, єсть
Єсьмо	є
Жалив’яний	кропив’яний
Жалива	кропива
Жалувати	жаліти, а також плакати
Жально	шкода
Жачкув	капшук
Жвака́ти	жувати
Же	що
Жеб	кишеня, щоб
Жебаловка	носова хустина
Жеби	щоб
Жебисце	якби
Жебня	кишеня
Жеболовка	носова хустинка
Желувати	бажати, а також жаліти
Жельний	зелений
Жем	що
Жені	жниці
Жентичка	сироватка
Же́реп	ялівець
Жерувати	здобувати їжу; бавитися
Жєти	жати
Живан	злодій
Живиця	назва горілки
Живо	швидко
Живот	життя
Живота	життя
Живчик	гілочка, яка відросла за останнє літо
Жидати	чекати, ждати
Жизнь	життя
Жила́	джерело води
Жи́рло	металевий загострений пруток, який розпікають і випалюють ним написи й зображення на деревині
Житнюшка	вид горілки за Польщі
Жіброванії (вівси)	засмічені осотом
Жіван	велет
Жіночий	такий, що належить дружині
Жісни́й	страшний, страхітливий
Жлукто	видовбана з цілої колоди велика діжка для пропарювання білизни; видовбана кадка без дна для зоління білизни, пристрій для відзолювання полотняної білизни
Жмакати	прати; жувати
Жмачок	жмут, шматок
Жмикати	прати
Жнякати	жувати
Жовні́р	солдат
Жога	печія
Жолоб	глибока і вузька долина
Жонца	управитель
Жорни́ти	молоти на жорнах
Жуковина	перстень
Журний	зажурений
З виплатом	вигідно, варто
З волоського боку	з Молдавії
З гури	з гори
З’ю́джувати	підбурювати, провокувати до злих дій
З’юдити	намовити на щось погане
За бодапрости дати	дати за упокій душі когось з померлих
За стодовком	за стодолою
За твоєю головою	під твоїм керівництвом
Забавлятися	затримуватися
Забандажувати	забинтувати
Забанджувати	забинтувати
Забанувати	затужити
Забеременіти	завагітніти
Забуртити	устромити
Зав’язнути	застрягнути
Завели́кий	завбільшки
Завержте	закиньте
Завивало	чалма
Завивка	покритка
За́видіти	заздрити
За́видувати	заздрити
Зависо́кий	заввишки
Зави́стувати	заздрити
Зави́ти	обгорнути, забинтувати, загорнути
Завити́ти	перевершити когось у чомусь
Завійки	ганчір’я
Заві́ритися	грізно глянути
Завітрити	занюхати
Завіхтьований	витертий змащеним чимось віхтем
Завоєць	пучок, збиток, складка, перев’язка
Заволайце	закличте
Завола́нка	набір новобранців до війська
Завор	засув
Заворітниця	жердина, якою перекривали ворота
Завсігди	завжди
Завсіди	завжди
Завше	завжди
Заганути	загадати
Загардувати	загатити
Загартка	куртка, верхня коротка одежина
Загін	грядка, виділена ділянка поля
Загінчий	пастух коло худоби
Заглавок	подушка
Заглибо́кий	завглибшки
Загловок	подушечка під голову
Заглумшений	придуркуватий
Загнати	послати
Загойкати	закричати, закликати
Заголовок	подушка
Загорнутися	одягнути верхній одяг
Загортка	верхня одежина, куртка
Загоститися	забаритися
Заграда	місто, город
Загривий	сірий (про тварин)
Загродова шляхта	окружна, повітова дрібна шляхта
Загру́бий	завтовшки, завгрубшки
Загрубіти	завагітніти
Загрубнути	завагітніти
Загуритися	замешкатися
Загутати	заколисати
Загута́тися	забаритися
Загуті́ти	зашуміти, застугоніти
Загучати	загудіти
Задарь	задармо
Задекований	закритий
Задекува́тися	заховатися
Заденчи́ти	забити дно в бочку
Задереві́ти	задерев’яніти, затерпнути
Задіти	зачепити за щось
Заднєнка	пряма кишка
Задобіддя	до обіду, перед обідом
Задудніти	застугоніти
Зажа́луватися	засмутитися
Зажу́та	тяжке становище
Зазвідатися	запитатися
За́здріти	побачити, помітити
Зазуй	взуй
Зайда	рядно, в якому носять скошену траву
Займи́ти	загнати худобу додому
Зайти	завагітніти
Зайти в тяготу	завагітніти
Заказнище (від заказник)	прикажчик, осавула
Закатру́пити	вбити, замордувати
Заквичати	жалібно закричати
Заки	поки
Заки сонце засвітило	поки сонце зійшло
Заки́м	доки
Закимарити	задрімати
Закиринений	забруднений, засмічений
За́клі	поки
Заклопати	постукати
Закля	поки,заки
Закоритися	прикинутися
Закусувати	загризати
Заку́тати	відшкодувати
Заладо́ваний	(про зброю) заряджений
Заладувати	завантажити
Зала́та	латка
Залатвити	залагодити
Залаяти	посварити
Залізко	пастка
Заложи́тися	побитися об заклад
Залу́биця	легкі санки
Залубні	сани з кузовом
Залудніти	забубніти
Зальоти	залицяння
Залюштати	зіпріти
Замага́ти	перемагати
Замари́ти	заморочити чарами
Замельдувати	доповісти, донести
Замельдуватися	зголоситися, з’явитися до влади, доповісти про себе владі
Замогти́	перемогти, побороти
Замогти́ся	розжитися, розбагатіти
Замок	замкнув
Замутитись	знайти привід
Заніз	палиця, що продівається в кінці ярма і замикає шию вола
Занія́чений	занехаяний, запущений
Заобсервувати	оглянути, обдивитися
Заодно	систематично, дуже часто
Заопасати	підперезати
Зап’яти	увіткнути, зачепити, причепити
Западня	пастка
Запаска	передничок, фартушок, спідниця; тип жіночого фартуха (поясного одягу у вигляді куска тканини шириною 60—70 см): полотняного, що одягається до спідниці або вовняного, що носиться до плахти та обгортки, шмат тканини, що носили замість спідниці поверх сорочки
Запашити	поширити приємний запах
Запекти хлівоньку	пролити кров у бою
Запиталиси	запитати
Заправотити	подати в суд
Запрагти	загнуздати коня
Запру́та	довгий дрючок для обв’язування сіна, соломи або хмизу на возі
Запудити	загнати кудись лякаючи
Запукати	постукати (у вікно або двері)
Запустікати	постукати в двері
Заран	вранці
Зарі́бок	заробіток
Зарі́нок	необроблена смуга землі над річкою; берег, покритий дрібними камінцями
Заріночок	бережок
Заріст	волосся на обличчі
Заря	заграва
Зас	знов, знову
Засилитися	зав’язатися
Засилітирувати	віддати честь по-військовому
Засколо́бити	нехотячи забити в тіло скалку
Заспати	заснути
Застава	загорода
Заставити	побитися об заклад
Заставитися	побитися об заклад
За́ставки (на всі за́ставки)	скільки є сили
Заставщина	закладання
Застати	заступити, закрити собою
Засторопі́ти	оторопіти, бути приголомшеним
Застрійте стріли	запустіть, направте стріли
Застум	глухе місце
Заступця	заступник
Засцярана	принижена
Зась	знову
Затий	заки, поки
Заточений	ув’язнений
Затушканий	прикритий
Затяготі́ти	завагітніти
Затяжіла	завагітніла
Заушниці	сережки
Зафасувати	одержати платню, гроші
Зафіґльовати	зажартувати
Захлюпати	постукати (у вікно або двері)
Заховаця	сховатися
Захтіла	захотіла
Зацерувати	муштруватися
Зачернути	зачерпнути
Зачиряти	зачерпувати
Зачудуватися	здивуватися
Зашелескотіти	тут зарябіти в очах від чийогось швидкого бігу
Зашмірений	замащений шміром
Зашпінькатися	застебнутися
Зашпортатися	спіткнутися
Зашпотатися	спіткнутися
Зашпріцувати	заперти на засув
Збабрана	брудна
Зба́вити	забрати
Зба́витися	зіпсуватись, зламатись
Збавлений	зіпсований
Зба́дати	обстежити по-лікарськи
Збан	дзбан
Збанка	дзбан
Зба́нок	дзбан
Збецкатися	тікати з пасовиська, брикати, рятуючись від кусючих комах (про худобу)
Зби́тки	жарти, пустощі
Збиткувати	тут чинити збитки, займатись здирством, знущатися
Збитошний	шкідливий
Збійник	розбійник
Збоя́тися	злякатись
Збритися	щезнути, вшитися
Зброд	волоцюга
Збродник	волоцюга
Збудитися	скоптитися
Збуй	розбійник
Звар’ювати	здуріти
Зваряти	золити, виварювати
Зведени́ця	покритка, одинока мати
Зведенята	діти від різних батьків, зведені в одну сім’ю
Зверла	скинула
Звестися	стати покриткою, одинокою матір’ю
Звикле	звичайно
Звідати	питати, взнавати
Звідати(ся)	запитати(ся),спитати(ся)
Звідатися	запитатися
Звідувати	питати
Звідуватися	питатися
Звіздяно	зоряно
Звізитирувати	перевірити, проконтролювати
Звір	ущелина в горах
Звір, звур	яр, улоговина
Звірка	звір, звірина
Звіта́тися	привітатися
Зволяти	дозволяти
Згабзувати	забракувати
Згальтувати	зупинити
Згара	зграя, банда
Згаратати	розтрощити
Зга́ркати	загарчати
Згирити	збути, продати
Згладити	знищити, звести зі світу
Згорбулівше	згорбившись
Здало	вдало, здорово
Здало би ся	треба
Здекутор	екзекутор, збирач податків; тут чиновник, який примусово збирав податки з застосуванням фізичного покарання боржника
Здер	топлене сало
Здецірка	муштра
Здибати(ся)	зустрічати(ся), зустріти(ся)
Здикуційні кошти	гроші, взяті шляхом екзекуції, в примусовому порядку
Здогадатися	пригадати
Здойми́ти	підняти
Здорожений	стомлений у дорозі
Здружити	звалити, скинути
Здрулити	скинути, звалити
Зело	рослинність, врожай
Земський	земний
Земя	земля
Зецерувати	муштруватися з примусу, примусово
Ззісти	з’їсти
Ззябнути	змерзнути
Зизаючи	гегочучи
Зима́рка	хатина і стайня в горах, де господарі взимку згодовували худобі сіно, що його неможливо було звезти до села, бо дуже круті гори
Зимівка	хатина і стайня в горах, де господарі взимку згодовували худобі сіно, що його неможливо було звезти до села, бо дуже круті гори
Зици́рка	солдатська муштра
Зицирува́ти	муштрувати, муштруватися
Зицірка	муштра
Зібрати(ся)	вбрати(ся), одягти(ся)
Зігнати	збудити зі сну
Зіперти	зупинити
Зістрі́т (до зістріту)	назустріч
Зладити	злагодити, приготувати
Злакомитися	спокуситися
Злапати	зловити, спіймати
Злапати(ся)	спіймати(ся), зловити(ся)
Златоглави	дорога верхня одежа з шовкової парчі, витканої або вишитої золотом чи сріблом
Злизи	сльози
Зличний	прекрасний, чудовий
Злівіти	полегшати (при хворобі)
Злосний	сердитий
Злочиста	золотиста
Змаламурити	з’їсти
Зме	ми
Змили́ти	здуріти, помилитись
Змітувати	скидати
Змнєцкати	зім’яти
Змняцкати	зім’яти
Змозолитися	стомитися
Змудрува́ти	обдурити, перехитрувати; тут змордувати, закатувати
Знаменами обкидати	оточувати полками
Знамено́	оберіг, який наділяв людину незвичайною силою
Знарошне	навмисно
Знару́чити	виручити
Зобачити	побачити
Зобідити	покривдити
Золотий	злотий, в старовину монета в п’ятнадцять копійок
Зопихати	товкти (просо)
Зору́дувати	облаштувати справу; придбати щось
Зостановити	зупинити
Зострійте	підготуйте, пристройте
Зохабити	лишити, покинути, залишити
Зохабляти	залишати, покидати
Зохобити	лишити, покинути, залишити
Зрабувати	загарбати, забрати, пограбувати
Зрихтувати	злагодити
Зрихтуватися	злагодитися
Зрокові	строкові
Зруцати	кидати
Зте	ви
Зубе́ла	вуздечка
Зубела́тий	загнузданий
Зубельці	уздечки
Зубила	вудила
Зуз	Західноукраїнські землі
Зумі́тися	здивуватися
Зунр	Західноукраїнська народна республіка
Зунуватися	втомитися
Зупа	суп
Зчалувати	зчарувати
Зчоун	Закордонні частини організації українських націоналістів
Зюбир	млиновий пристрій для очищення зерна від шкірок
Зябко	холодно
Игла́	голка
Ип	весь час, постійно
Истик	дерев’яна паличка з залізним наконечником, якою чистять
Ись	ти
Іграти	танцювати
Іґрас	аґрус
Ід	до
Ідце	йдіть
Із трисунков	з косицею за капелюхом
Ізбарзе	дуже
Ізво́р	джерело, що наповнює водою криницю
Ізгвалтувати	тут збентежити
Ізгладити	знищити, звести зі світу
Іздоймила	зняла
Іззябнути	змерзнути
Ізиздріти	побачити
Ізмагається	силується
Ізояти	схопити
Ізтямити	зауважити, помітити
Ізувезди	звідусіль
Імати	ловити
Іматися	чіплятися
Іма́ш	пасовище
Іми́ти	зловити, спіймати
Іми́тися	загорітись (про вогонь); вчепитися
І́мость	попадя
Інаш	царський слуга
Інджібаба	Баба Яга
Іно	тільки, лише
Інош	прислужник, джура
Іста	справжня
Істий	справжній
Істикнути	охопити зором
Істичок (від істик)	паличка з залізним наконечником, якою зчищають землю з плуга
Ісц	іти
Іти води	іти по воду
Ітійор	лікер
Іши	ще
Ї	її
Їда	рот
Їдат	їсть
Їден	один
Їдення	їда
Їдло	страва
Їднати	тут завойовувати, примушувати силою
Їдно	одне
Їмати	ловити
Їматися	загоратися
Їми	візьми
Їми́ти	зловити, спіймати
Їмитися	вчепитися
Їмос(т, ц)ь	попадя
Й а	а (часто в піснях вживається замість складу для збереження ритму)
Йми́ти	зловити, спіймати
Йми́тися	загорітись
Йно	тільки, лише
Йо	так (ствердження)
Йойкати	плакати
Кабак	гарбуз
Кабат	куртка, солдатський мундир
Кабатик	спідничка
Кабачна	шинкарка
Кабая	рід одежі
Кав’ярка	бляшана банка
Кава	сива ворона, галка
Кавалок	шматок
Кавальчик	шматочок
Кавка	сива ворона, галка
Кавулька	кривулька
Кавуля	кривуля
Кавуник	сива ворона, галка
Кавція	картярська ставка
Ка́гла	отвір-вхід у димар, комин, внутрішня частина комина
Каглянка	онучана затичка для димаря від печі
Каді	коли
Кадук	чорт
Кадь	бочка, ванна
Каждий ся виспит в заглавку	кожний виспиться на подушці
Каза́н	відро
Ка́за́ння	проповідь священника в церкві
Калабаня	калюжа
Калабатина	калюжа, баюра
Калаба́ч	вибоїна на дорозі
Калав́ур	караул
Калай	капелюх
Калап	капелюх
Калапушка	чарочка (посудина)
Ка́лфа	старший, організатор серед парубків або серед музик
Кальбу́ка	ціпок для старих або немічних
Кальвин	нелюд
Кальга	піч
Калюх	черево, нутрощі в череві
Калюха́тий	череватий
Калюхи	кендюхи, нутрощі
Камарат	товариш
Камаша	сорочка
Камера́льний	державний
Камеша	сорочка
Камизелька	жилетка
Камізе́лька	безрукавка
Камлицькі князі	кримсько-татарські хани
Камрати	товариші
Камратиська	товариші
Камраття	товариші
Кандиро́па	арештантська камера
Кандьор	бідняцька юшка
Кано́н	тут гармата
Канона	гармата
Канта́р	гнуздечка, вуздечка, уздечка
Кантарка	гнуздечка
Кантарок	гнуздечка, вуздечка, уздечка
Канцюба	ціпок
Канюка	назва птаха
Каня	птах (коршун)
Капа	підріз дерева з того боку, в який воно має бути звалене
Капарство	неакуратна бідняцька робота
Капе́йстра	гнуздечка, вуздечка, уздечка
Капелія	оркестр
Капе́ло	солдатський чоловічий головний убір
Капестра	гнуздечка, вуздечка, уздечка
Капець	шкіряне скріплення в ціпові
Капиця	шкіряне скріплення в ціпові
Каплювати	з’єднувати
Капура	ворота
Капурка	фіртка
Ка́пці	плетені з вовняних ниток шкарпетки
Кар	вагон
Карабути йти	летіти шкереберть
Караван	винокурня
Каравати	одяг
Карбач	батіг, нагайка, канчук
Карбник	мала господарська прибудова, курник
Карбованці	дукачі
Карічка	коло
Кармазин	сукно темночервоного кольору; тут дорога верхня одежа з кармазину
Карман	кишеня
Карнет	книжечка, посвідчення
Карник	мала господарська прибудова, курник, хлівець-прибудова, маленький хлівець
Карничок	маленький хлівець
Карта	повістка, лист
Карташ	картяр
Картка	повістка, лист
Картофлі	картопля
Картятися	грати в карти
Кару́ца	віз
Каса́рня	казарма
Каса́та	скринька
Касе́тка	скринька
Кастрівка	простий фетровий капелюх, на відміну від прикрашеної перами крисані
Катанка	жіноча куртка, тут: мундир солдатський
Катафе́йка	смертне ложе
Катафель	смертне ложе
Катафелька	катафалк
Катафе́льок	смертне ложе
Катка	ополонка
Катра́н	шматина, ганчірка, ганчір’я
Катрання	ганчірка, ганчір’я
Катрінца	буковинська запаска
Катруца	порожнина під піччю для зберігання картоплі тощо
Катун	солдат, рекрут
Катуна	солдат, солдатчина
Кач!	гиля!
Качівка	качалка
Качя	каченя
Кашиця	дерев’яне укріплення річкового берега в горах
Кашівка	качалка
Каштани	тут: вороні коні
Каштіль	палац
Каюк	річковий човен, зроблений з цілої колоди
Каянний	окаянний, проклятий
Квадр	чверть
Кварта	чашка
Кватера	тут місце в шинку
Кватира	тут кватирка
Квати́рка	чверть літра, посудина на чверть літра
Кваша	болото; страва з житного борошна і ягід
Квичати	жалібно кричати
Кеби	якби
Кед	коли, коли б
Кеда	коли
Кедзь	коли
Кедь	коли, якщо
Келеп	чекан, палка з рукояткою, звичайно з металевою набивкою
Ке́льнер	офіціант
Кельо	скільки
Кельчик	витрати, кошти
Кельчік	видаток, кошти
Келюх	черево, нутрощі в череві
Кем	дай, подайте; тут — коли
Кендериця	кукурудза
Кендюх	шлунок четвероногих тварин
Кеньдюх	шлунок четвероногих тварин
Кеоун	Крайова екзекутива організації українських націоналістів
Кепень	військова шинель
Кепеняк	опанча
Кептарик	кожушок-безрукавка
Керва	кров
Керни́ця	криниця
Керничка	джерело води
Керпці	взуття (постоли)
Керт	город, квітник, сад, садочок
Керта	город, сад
Керти́на	кріт
Керунок	напрямок
Кесарня	казарма
Кестемен	хустина
Кет	коли
Кетефик	вуздечка
Кеть	коли, якщо
Кєрунок	напрямок
Киба́вка	барки
Кибал	обруч із тканини, дерева, лози, який підкладали під очіпок на голову
Кибалиця	обруч із тканини, дерева, лози, який підкладали під очіпок на голову
Кибалка	обруч із тканини, дерева, лози, який підкладали під очіпок на голову
Кива́ти(ся)	зачіпати, ворушити(ся), торкати(ся), рухати(ся)
Киватися	ворушитися
Кикоть	обрубок руки в каліки
Ки́ла	центнер
Кильо	скільки
Кимак	колода
Киндюх	шлунок четвероногих тварин
Киндяк	рід бавовняної тканини; тут різнокольорові смуги на одежі
Кину́ти	торкнути, зачепити; поворушити
Кинутися	поворушитися
Кипта́р	кептар, гуцульський верхній хутряний одяг без рукавів, короткий кожушок без рукавів
Кирва	кров
Кирд	отара
Кири́нити	засмічувати, забруднювати
Кири́ня	засміченість, непорядок, нечистота
Кирлиг	довга чабанська палиця з гачком
Кирни́ця	криниця
Киртіс	городник, садівник
Киселиця	борщ вівсяний
Кить	коли, якщо
Кицка	грудка
Кичера	гора
Кияк	кий
Кияхи	кукурудза
Кіби	якби
Ківер	головний убір з твердої шкіри
Кіженькая	тяженькая
Кізли	крокви
Кійло	тирса, ковила
Кілко-то	скількись
Кілько	скільки
Кіля	коло, біля, кілограм
Кіма́к	дрючок, шматок дерева
Кімиш	пам’ятаєш
Кімува́ти	пригадувати; метикувати, гадати, пам’ятати, тямити, знати
Кінва	дерев’яний посуд для пиття, місткістю близько літра
Кірва	кров
Кірон	бригадир на лісорозробках
Кісто	тісто
Кістя	кістки
Кі́тлик	казанок
Кіцкати	прибирати (гній, болото на подвір’ї тощо)
Кіш	козацький табір; тут місце розташування військового керівництва, центр Запорозької Січі
Кішасонка	панянка
Кішасонька	пані
Кішкати	доглядати, вигодовувати (скотину)
Кішня́	косіння
Клавець	молоток
Кла́ка	толока, спільна праця з метою допомогти односельцеві
Кла́ня	тридцять штук будь-чого; полукіпок, півкопи, тобто 30 снопів
Клапачка	зимова шапка березівського типу
Кла́сти	ставити при владі
Клебан	капелюх, римсько-католицький священик
Клебанка	капелюх
Клева́к	шмат
Клеве́ць	молоток
Клейноди	атрибути влади
Клейноти	дорогоцінності
Клепач	молоток
Клинець	кілочок у стіні, вішалка
Клинці	цвяхи, вухналі
Клит	комора
Клич	репутація
Кліпи	повіки
Кліт	комора
Кліть	комора
Клуб’я	клубок
Клумак	клунок
Клу́нтя	дрантя
Клюка́	палиця-кривулька, палиця з загнутим кінцем
Клюпити	куняти
Ключка	дерев’яний крюк
Ключник	наглядач над невільниками на галері
Кляйники	одяг, одежа
Клякати	ставати навколішки
Кляча	шкапа
Княги́ня	наречена на весіллі, молода
Князь	наречений на весіллі, молодий
Кобел	міра ваги (96 кг)
Кобе́лці	килимки на підлогу
Кобеняк	верхній чоловічий одяг, суконний довгий одяг з капюшоном
Коби́	якби, ніби, коли б
Кобила	тут: брак, допущений під час роботи на ткацькому верстаті
Кобівка	кошик з лепехи
Кобілка	коробка
Ковалнік	коваль
Ковальня	кузня
Кова́рня	порожнина
Ковач	коваль
Ковба́й	дерев’яний черпак для води
Ковбан	відпиляний шматок колоди
Ковбань	Кубань
Ковбиця	відпиляний шматок колоди, на якому рубають дрова, передній отвір печі
Ко́вбо́к	відпиляний шматок колоди
Ковбочки	відпиляний шматок колоди
Ковган	дерев’яна довбана посудина, в якій розтирають сало з цибулею, щоб затовкти борщ
Ковганка	дерев’яна довбана посудина, в якій розтирають сало з цибулею, щоб затовкти борщ
Ко́вня	шматок колоди або викорчуваний пеньок
Ковпачок	скальп
Ко́втати	стукати, вдаряти
Ковтки	сережки
Ковтнути	стукнути
Ковток	сережка
Ковшу́н	ківш
Когут	півень
Кожі́вка	кужівка, кілок, на який намотують прядиво для прядіння, кужіль
Кожілка	кужіль
Козел	кроква
Козеня	здерта з козеняти шкура і перетворена на великий гаман
Козублю	козубенька, кошіль
Козяки	кінський гній
Кой	коли, раз, якщо
Коко	яйце
Коковевка	сова
Колдувати	чаклувати
Колега	товариш
Колесечка	коліщата
Колешня	стайня
Колєга	товариш
Колєґувати	товаришувати
Колєжанка	товаришка
Колєйо́вий	залізничний
Коли́ба	житло (халупа) чабанів і лісорубів, лісова хатина круглої форми, в якій ночували лісоруби або люди, що працювали на лісопосадках
Колик	кілок
Колієчка	залізниця
Колімазь	мастило до воза
Колішки	передня частина плуга
Ко́лія	залізниця
Коло́диця	криниця у вигляді встромленого в землю кадоба
Колоді́й	майстер, який виготовляє вози, сани, колеса; стельмах
Колокол	дзвін
Колопні	коноплі
Колосина	колоски й солома, що витрясалися з воза після вивантаження снопів
Колот	колотнеча, битва
Коль	коли, якщо
Команиця	конюшина
Кома́шня	поминки після похорону
Комендерувати	командувати
Комерцію мати	мати з кимось мороку, неприємні стосунки
Ко́мин	димар
Комірзатися	вовтузитися
Комі́рне	наймане бідняцьке житло
Комірса́тися	вовтузитися
Комоситися	вовтузитися
Компанійці	тут козаки-кіннотники в XVIII ст
Компаністка	товаришка
Компанія	тут рота, військовий загін
Компанія війська	рота війська
Комутити	каламутити
Конар	сук, гілляка
Конарі	гілки
Конина	кінь, коняка
Коно́вик	дерев’яна посудина з клепок для носіння води
Коновка	дерев’яна посудина з клепок для носіння води, дерев’яна або залізна кружка, відро
Контентуватися	задовольнятися
Конте́тний	вдоволений частуванням або чим іншим
Контетува́ти	задовольняти, гостинно приймати
Контетуватися	задовольнятися
Контигент	податок
Контрат	контракт
Конфідент	поліцейський агент, шпик
Коняки́	кінський послід
Конячки	кінський послід
Копа грошей	тут 50 копійок
Копаниця	конюшина
Копач	палиця
Копачик	паличка
Копил	байстрюк
Копиля	байстря
Копита	шевські копили, або колодки
Копито	шевський копил
Копна	копиця
Копнути	ударити ногою
Копнутися	причепитися до когось
Коралі	намисто
Корбач	батіг
Корець	міра сипучих тіл, центнер
Корза́н	постіл
Корман	мотуз, вірьовка
Кормига	тяжка неволя
Корняти	будити, квапити, підганяти, зганяти
Коровод	хоровод, коло
Корогва	тут запорозький прапор
Корогод	хоровод, коло
Коруна	корона
Корч	кущ
Коршун	яструб
Косарі́	сузір’я
Косиці	квіти
Коси́ця	квітка
Ко́тики	щиколотки
Котіш	кучер
Котора	біда
Котюг	кусок, шматок
Котя	кошеня
Ко́хля	кухонний черпак
Кохта	кофтина, блюзка
Коц	укривало
Ко́цкати	стукати (щоб відчинили)
Коцурка	кішка
Коч	бричка, карета
Коч смертельний	смертне ложе
Ко́чало	кільце
Кочерги́	кут біля печі
Кочиг	карета, бричка
Кочіга	карета
Кочі́ння	пологи в овець і кіз
Кочіш	візник, погонич, кучер
Кочія	бричка, карета
Кош	козацький табір; тут місце розташування військового керівництва, центр Запорозької Січі
Кошар	кошик
Кошеля	сорочка
Кошниця	пристрій для зберігання кукурудзи в качанах
Кошовий	начальник коша
Кошовий отаман	військовий керівник Запорозької Січі
Кошт давати	харчувати
Кошулейка	сорочина
Кошу́ля	сорочка; лишай
Кпити	насміхатися
Крава	корова
Кравати	хорвати
Крадом	крадькома
Крадьки	крадькома
Крайка	тканий жіночий пояс
Крайник	управитель краю в Карпатах
Крак	гілляка
Кральове	королі
Крамний	куплений у крамниці, на відміну від виробленого по-народному вдома
Красна	красива
Красний	чудовий, хороший, гарний
Красні	гарно
Красно	гарно
Красовиця	красуня
Красянистий	рябий
Кре́денс	комод, шафа для посуду й харчових продуктів, кухонна шафа, буфет для посуду
Кре́денц	комод, шафа для посуду й харчових продуктів, кухонна шафа, буфет для посуду
Крезент	повітове, окружне начальство
Крейсамт	повітове, окружне начальство, влада
Крейцат	австрійська копійка
Крейцер	дрібна монета Австро-Угорщини
Кремінал	в’язниця, тюремний замок
Крепірувати	мучитися
Кресанина	бриль, капелюх
Криваня	крива палиця
Кривдний	покривджений
Криж	хрест
Криж(А́, е́)вка	головка капусти
Крижем ударитися	упасти в знемозі, знепритомніти
Кри́жмо	біла тканина, у яку сповивають дитину хрещені батьки після обряду хрещення
Крижовник	аґрус
Кризент	повітове, окружне начальство, влада
Криміна(Л, р)	тюрма
Кри́са	щур; відігнутий край капелюха
Крисаня	гуцульський капелюх
Крич’їв би’м	кричав би я
Криша	дах
Крі́вний	кривавий, кров’ю здобутий
Крі́с	рушниця
Кровать	ліжко
Кро́кіс	вир у річці, дикий шафран
Кроковеє колесо	сонце
Крокос	дикий шафран
Кромплі	картопля
Крона	чехословацкая денежная единица
Кросна	ткацький верстат
Крулевські ляхи	тут королівська шляхта
Круль	король
Крумплі	картопля
Крунулася	кинулася, повернулася
Крутий	недобрий, лихий
Крутні	жахливо
Кряк	кущ
Крятати	повертати у кінці гону в нову борозну
Крячок	1) назва птаха; 2) лісок
Ксьондз	священик
Ку	до
Кубок	тут металевий посуд для пиття вина або горілки, велика чарка
Кугу́т	півень
Кугутки́	сережки
Кужіль	розчесаний і підготовлений до прядіння льон чи коноплі
Кузнець	коваль
Кукіль	бур’ян
Кукільниця	турботлива, старанна жінка
Кукуц	маленький круглий хлібець
Куле́ша	страва з кукурудзяного борошна; мамалиґа, варений хлібний продукт з кукурудзяного борошна
Ку́лко	кільце
Кульбака	сідло
Куманиця	конюшина
Кумісний	з фабричної тканини
Кумна́т	чоловік жінчиної сестри
Кумната	дружина чоловікового брата
Кумнаття	множина від слова «кумнат»
Кумпанія	золота чарка
Кунте́тний	задоволений
Купавая	гарна
Куренци	оголошення
Курецейні	податок за курей
Курінь	невеликий козацький військовий підрозділ, а також невеликий населений пункт чи примітивне житло
Курма́н	мотуз, вірьовка
Курме́й	мотуз, вірьовка
Ку́рмик	мотуз, вірьовка
Курта	коротка, маленька
Куртий	короткий
Куршивий	паршивий
Ку́ря	курча
Ку́рятко	курчатко
Кус	трохи
Кус(а́, о́)к	шматок, кусок
Кусціся	кусник, трошки, трошечки (кус-трохи)
Ку́тання	порання
Ку́тати	доглядати, вирощувати (про дитину, худібку)
Ку́татися	поратися
Кутець	саж, хлівець
Кутуз	тюрма, в’язниця
Куфа	бочка
Ку́фер	скриня, скринька, чемодан
Куферок	скриня, скринька, чемодан
Куфрик	скринька
Кухва	бочка
Кухня	кухонна плита
Куцко та бирко	собаки-вівчарки
Куча	хлів, занедбана хата
Кучерєвий	кучерявий
Кучімка ягнячка	хутрова шапка
Кучія	бричка
Ку́чма	шапка з овечого смушка
Кучно	сумно, нудно
Ку́шати	пробувати на смак, куштувати
Куши	тут: їж
Кушуля	сорочка
Кячері	кущі
Лаба	лапа
Лаба́тий	довгоногий
Лабда	м’яч
Лабдаючись	граючись м’ячем
Лабу́з	бадилля
Лабу́нда	верхня бідняцька одежина
Лавиця	кладка через воду
Лавка	кладка через річку або струмок
Лавор	діжка, тазик
Лада	ящик, скриня
Ладанка	коробочка з чимось важливим, яку носили на шиї під одягом
Ладичка	скринька
Ладівниця	тут патронташ
Ладува́ти	накладати, вантажити; тут: готувати
Лазиво	драбина
Лайда́к	ледар, волоцюга, лінюх, уживається як лайка
Лайдака	ледар, волоцюга, лінюх
Лайдакувати	ледарювати
Лайтан	рейтар; переважно так називали найманих іноземних солдатів-кавалеристів
Ла́ким	ласий, охочий до чогось
Лакомий	пожадливий до чогось
Лакомитися	спокушатися
Ланвіт	війт
Ланц	ланцюг
Лапай	лови
Лапайце	хватайте, ловіть
Лапати	ловити
Лапа́ти(ся)	ловити(ся)
Лапті	постоли
Ларма	лемент, ґвалт
Лата	горизонтально прибита жердина в огорожі
Латер	кубометр дров
Лах	стара зношена одежина
Лаха	одежина
Лахабунда	волоцюга
Лахаші	погане взуття
Лахи	подертий, потріпаний одяг, старий одяг, дрантя
Лашшя	ганчір’я
Лву	Ліга визволення України
Левенець	парубок, молодець
Левеш	страва
Легіник	парубок
Легінь, леґінь	парубок, молодець
Легма	лінюх
Леґінь (легінь)	парубок, хлопець
Леда-який	який- небудь
Ледіник	парубок
Ледінь	парубок, молодець
Ледонько	льодок, льодонько
Ле́жа	тривале лежання при тяжкій недузі
Лей	румунська грошова одиниця
Лелька	лелека-самиця
Лем	лише, тільки, але, лиш
Лем сом сам	тільки я сам
Леманути	побігти
Лементар	регіментар, воєначальник, командуючий військами
Лементувати	кричати
Лен	льон
Ле́нія	лінія, широка межа в полі, ряд
Ленча	сочевиця (їжа із сочевиці)
Леп	липкий бруд
Летяга	нетяга, бідняк, у якого немає худоби, майна, навіть домівки
Лєший	лісовик (з рос. фольклору)
Ли	чи
Лигну́ти, лиґну́ти	ковтнути, проковтнути
Лижка	ложка
Лиманити	смалити (кабана)
Линва	довгий мотуз
Липанда	липка живиця
Лискар	рискаль, лопата для копання
Лискарювати	копали лискарем
Лисковий бук	лисковий кий, кий з міцного горіхового дерева, що блищить від довгого вживання
Лисни́ця	кислиця, яблуня-дичка
Листи визволенні	документи, грамоти про звільнення від рабства або кріпацтва
Листя	тут документи, листи
Личи	лише
Ли́ччя	лико
Лишка	лисиця
Лівер	домкрат
Ліво́рвер	револьвер
Лігати	лягати
Лідвоньки	бедра
Лі́жник	гуцульське вовняне укривало на ліжко
Лізти в дуб	лізти на дуба
Лім (род. відм. лому)	хмиз
Лінкшав	ліворуч
Ліпша	краща
Ліса	плетений з лозового пруття тин, огорожа з ліщинових палиць
Лі́ска	зроблена з ліщинових паличок фіртка або задня засувка у возі
Лісковий	ліщиновий
Лісна́	лісова русалка
Лісні	тут урядовці
Літепло	тепла вода
Літорус	пагін лози, що виріс за літо
Лі́ци	віжки
Ліцитація	описування майна за борги
Лічений	лікувальний
Лови́тися	чіплятися
Ловкий	придатний до чогось, досконалий
Логаза	ячмінна каша
Логаль	гоголь
Лодка	човен
Локоть (полотна)	старовинна міра довжини, приблизно півметра, тобто від ліктя до кінця середнього пальця руки
Лом	хмиз
Лонка	лука
Лопта	м’яч
Ло́скіт	стукіт
Лотоки	жолоб, по якому тече вода на млині
Лоточи́ти	набридати доріканнями; набридливо базікати
Лошук	лошак, молодий кінь
Луб	кора
Лубка	посудина з лубу
Лубочок	вулик
Луг	розчин попелу з окропом для зоління полотняної білизни
Лугови́ння	лоза
Лу́дина	одяг домашнього виготовлення
Лу́диння	одяг домашнього виготовлення
Лудинячко (від лудина)	одежина
Лужко	ліжко
Луйтра	драбина
Лукошко	луб’яна коробка
Лун	Легія українських націоналістів (створена в 1925 р. в Чехії, м. Подеброди)
Лунга	долина, улоговина
Луну́ти	кинутись до когось або чогось
Лупати	розбивати, розламувати (камінь), колоти
Лупи́ти	обчищати від шкаралупи; здирати шкуру
Лупня давати	прочухана давати
Луст	шматок
Луста	шматок
Лустка	скибка (хліба)
Лутра	драбина
Луфт	повітря
Лу́цькати	лупцювати, бити
Лучитися	трапитися
Лучче	краще
Луччого клича	хорошого імені, доброї слави
Луччої руки	майстер на всі руки
Лу́шниця	смолоскип
Льо́га	фантастичний птах
Льогр	шпиталь
Льокай	лакей
Льонд	країна, земля
Льос	жеребок
Льофа	ствол вогнепальної зброї
Льоха	свиня
Люба́	любов
Люба́с	коханець
Люба́ска	коханка
Людкове	люди (вживається при звертанні)
Людська денежка	копійки старцям, жебракам
Люлька	колиска
Лю́стро	дзеркало
Люфт	отвір для вентиляції; повітря
Люфтаки	отвори для вентиляції
Люфтува́тися	прогулюватися на свіжому повітрі
Ля́да	прилавок
Лядуй	гадай, міркуй
Лядчина	Галичина
Лящик	корець
М’ясни́ці	період після посту, коли можна їсти м’ясо, одружуватись
Магазинє́р	продавець
Маглювати	катати білизну
Маґлі́вка	дерев’яний брусок з рівцями для відкачування білизни; дерев’яна дошка для розпрасовування білизни
Маґлівниця	дерев’яний брусок з рівцями для відкачування білизни
Маєран	зілля пахуче
Мажа	міра ваги (100 кг)
Мазниця	цеберка для тримання дьогтя; велика чорна смушкова шапка
Мазюка	мастило
Май	слово для утворення вищого ступеня прикметників (май сильний, сильніший)
Майданник	працівник, який працює на майдані, тобто на підприємстві по виготовленню дьогтю
Майданчики	майданники, смолокури
Майна	місце, де випалювали деревне вугілля
Майшля	сумка
Макортетя	спеціальна мисочка
Малай	хліб з кукурудзи, гороху або проса; погано спечений хліб, в’язкий, кукурудзяний хлібець
Малахай	канчук, нагайка
Маленько	трошки
Малити	бути комусь чогось мало
Мало	трохи
Мальфе́й	чаклун
Малює ся	фарбується
Мам	маю
Маме	маємо
Мандатор	особа, що діяла за певним дорученням; тут уповноважений поміщика, управитель маєтками в кол. Галичині та Буковині, управитель панського маєтку
Манджати	мандрувати, швидко йти
Мандибу́рка	картопля
Мандибу́ряник	картопляник
Манерка	фляга
Манірка	фляга
Маністо	намисто
Манта́	свита з домотканого сукна
Мара	чаклунка
Марґа	худоба
Марець	март, березень
Маржи́на	худоба
Маржинка	худібка
Маркірувати	хитрувати
Маркітно	сумно, тужно
Марко́тний	невдоволений, сумний
Марфа	товар, який транспортується
Марципан	солодощі польського походження
Маршкати	кричати «марш», проганяючи когось
Маса	канцелярія в справах успадкування майна
Масіровати	марширувати
Масть	жир
Мат	має
Мати дяку	мати охоту
Маточка	названа мати
Мать	мабуть
Махом	дуже швидко, миттєво
Мац	мати
Мація	діло («Чи то велика мація?»)
Мацур	котик, кіт-самець
Мацю́пкий	малесенький
Маця	дерев’яна міра на зерно, 16 кг
Мачка	кішка
Мачула	рогожа, мочала
Маш	маєш
Машингвер	кулемет
Маштальня	стайня, конюшня, хлів
Маштига́нити	лупцювати
Маштигувати	лупцювати
Маю́чий	заможний
Ме	буде
Меблівницев	рублем для качання білизни
Меда́рка	медогонка
Медже	поміж
Межівник	той, хто має поруч землю, межа в межу
Мей	моєї, румунське фамільярне слово при звертанні
Мелай	кукурудза
Мелеструватися	скаржитися
Мельдува́ти	доповідати, повідомляти владу, сповіщати, доносити
Мельдуватися	реєструватися
Мельниця	млин
Мемо	будемо, станемо
Мене рік погодив	мене доля помилувала
Ментив	швидка медична допомога
Мерза	гидота
Мериндя	їжа, що бере із собою пастух у поле
Мерша	мертвечина
Ме́те	маєте, повинні, будете
Метер	центнер
Метиця	мука, що вимітається, коли піднімають млиновий камінь
Меч	кидай
Меш	будеш
Меш (він ме, вони муть)	будеш
Мешти	туфлі
Ми	мені
Мигичка	мжичка, мряка, дрібний дощик
Миготати	блистіти
Миґла	складометр
Ми́дниця	велика лужена миска (для миття), велика господарська миска
Ми́кати	виривати, скубти, смикати
Микатись	тинятись
Микнути	скубнути
Милка	люба
Миро́м	по-доброму
Митернішок	Клемент Меттерніх (1773-1859), австрійський державний діяч, реакціонер
Мито	пошлина, плата за право торгувати; тут плата за право проходити землею, мостами чи шляхами якогось магната або держави
Мичка	шнурок з клоччя; штука лляного або конопляного прядива, з якого пряли веретеном або на прядці нитки, в’язка льняного або конопляного волокна, підготовлена для прядіння
Мишиніна	сало з м’ясом
Мі	мені, йому
Мівка	мілка
Мізельний палець	мізинець
Мізерний	мізинний (палець)
Мізилний палець	мізинець
Міло	дрібно, мілко
Мілоч	дрібні гроші
Мінити	обіцяти
Міні	мені
Міріють	міряють
Міст	тут стіл
Мітка	старовинна міра ниток 40—50 пасом
Міто́вка	мітла
Міціцький	малюсінький
Мішанина	страва, м’ясо, варене разом з салом і приправлене перцем
Мішати	заважати
Мішити	заважали
Міща	торбина
Міщулик	торбинка
Міщу́р	міщанин, мешканець міста
Млака	мочар, заболочена земля, багниста земля, калюжа
Млива	зерно, злагоджене до млина
Мливо	зерно для помелу; щойно змелена мука
Млинець	млинок
Мнє	тут: ім’я
Мні	мене
Мня	мене
Мої	моє
Мой	простацький (фамільярний) вигук при звертанні
Молнія	блискавка
Молов	дамба
Молот	тут військові сутички, битва
Мольмеся	молімося
Монарха	монарх, імператор
Монетки	достатки, майно
Мор(ґ, г)	міра площі землі, що дорівнює 0,56 га
Мори	хвороби
Моркотати	бурчати
Москалики	тюлька
Мостивий	знатний пан, великий вельможа
Мо́цний	міцний, сильний
Мо́цно	добряче, сильно
Мочар	трава; місце з підґрунтовою водою, мокрий грунт, болото, низьке, болотисте місце, трясовина
Мочела	мочар, багно
Мочи	могти
Моша	жінка, яка приймає пологи
Моше́нка	гаманець з баранячої калитки
Мошкоро́дити	шарудіти
Мрак	мряка
Мругнути	моргнути
Му	йому,
Муй	мій
Мультанська земля	тут земля, підлегла турецькому султану, зокрема молдавська
Мунду́р	військова форма, уніформа, однострій; одяг
Мурафлина	болотяна ягода
Мурзак	татарин
Мурий	темно-сірий, з п’ятнами (масть)
Муриндель	мурашка
Муро́вий	сміливий і зухвалий, зухвалий і нахабний
Муші́я	велике, панське землеволодіння, майно (земельне)
Мя	мене
На бекеті	на сторожі
На вішки давала	повідомляла
На все	назавжди
На гостину	в гості
На збит говорити	знущатися
На мус	примусово
На прикові	бути прикутим до чогось
На убочи	на краю
На фоні	на тлі
На четвереньки стати	рачки стати
Набізовно	напевно
Наблюдати	спостерігати
Набор дати	дати в борг, без грошей
Наборсучитися	набурмоситися
Набува́тися	гарно проводити час; милуватися
Набутки	гуляння
Наважитися	наполягти, напосістися
На́видіти	любити, прихильно ставитися
Навидітися	бути прихильним один до одного
Наві́кіті	на змагання
Навкі́рки	наперекір
Навра́з	назавжди
Наврятити	тут приготувати, зібрати
Навстрі́ть	назустріч
Навт(є, я)митися	наскучити, набриднути
Навхтема	назавжди
Нагаї	тут кримські степові татари, ногайська орда
Нагайці	тут кримські степові татари, ногайська орда
Нагая	гола
Нагили́ти	нарадити щось комусь
Наги́лювати	нараджувати комусь щось непотрібне
Нагла	гола
На́гло	раптово, зненацька
Нагору	на горище
Нагрузити	навантажити
Нада	треба
Надавати	наполягати
Надибати	знайти
Надибувати	знаходити, зустрічати
Надівати	надіятись, сподіватись
Наді́жна	вагітна, тільна (корова)
Надіжний	впевнений
Наділок	тут піхва для шаблі
Надоли́ну	вниз
Надольський	анатолійський, турецький
Назуп’ять	лицем назад
Наїсно	навмисно
Най	хай, нехай
Най, няй	хай
Найми́тися	найнятися
Наймитя	наймити
Найомчик	бідняк, якого багатії наймали іти за них до армії в солдати
Найпу́щий	найгірший
Найскрутніша	найпроворніша, найжвавіша
Найти́ся	зустрітись
Накавулити	написати щось незрозумілими кривулями
Наказувати	карати
Наклад	податок
Наклебта́ти	звести наклеп
Наколи́	коли; після того як
Накорпа́ти	потроху назбирати, накопичити
Накпиться	насміятися
Наладити	підготувати
Наладитися	налякатися
Наладувати	навантажити
Наленути	налинути
Налуж	наложи
Намість	замість
Нана́шка	хрещена мати, хрещена мами
Нана́шко	хрещений батько
Наникнутися	натрапити
Наостріт	напередодні
Наостріть	назустріч
Напаровати	назбирати, зекономити
Напатряся	надивляється
Напахатися	нанюхатися
Наперебесаг	нав’ючення на верхового коня внтажу, коли два мішки звисають з двох боків сідла
Наперебисадки	через плече, одна торба за спиною, друга
Напе́ртися	упертися, особливо наполягати на чомусь
Напирати	просити
Напоперек	навпростець
Направець	навпростець
Направці	навпростець
Напригото́ві	напоготові
Напропале	напризволяще
Напря́тати	назбирати
Напу́дитися	налякатися
Нарадів	завдання
Нара́з	зразу; раптом
Нарачки	рачки
Наривати (ярма)	прикріпляти ярмо до дишла, запрягати
На́рік	наступного року, на наступний рік
Нарозумитися	набратися розуму
Нароковати	іти до війська, виступати в похід
Нароком	навмисно
Нарошне	навмисно
Нарукувати	іти до війська, виступати в похід
Нару́чувати	рекомендувати когось
Насад	частина воза: подушка зверху осі
Наскоро	якщо
Наслідство	спадок
Наспак	навпаки
Настановляти	призначати, назначати, научати
Настояти	наполягти
Натина	дика лобода, бадилля
Натиски коню	натискати на коня, бити в боки стременами
Натще	не ївши
Наущати	навчати
Нафта	гас
Нафтов обілляти	облити гасом
Находка	знахідка
Нахтема	назавжди
Нацапки	рачки
Начасниче́ний	приправлений часником
Начини́ти	понароджувати, народити
Начиня	посуда
Нашпарува́ти	зекономити, запастись
Наштукувати	доточити
Наюдити	підбурити, намовити на щось недобре
Наяти	найняти
Наятися	найнятися
Нвро	Народно-визвольна революційна організація
Не бай	нічого, не біда
Не є	нема
Не знобився	тут невдача
Не ледайкому	не абикому, а достойній людині
Не любитися	не подобатися
Не патри	не дивися
Не смім	не смію
Не сталайся	тут: не журися
Не стало косту	не стало змоги
Не хлопець	тут не кріпак
Нев	нею
Невбо́рзі	невдовзі, незабаром
Невзначай	ненароком
Неві́льно	не можна, заборонено
Невіста	невістка; дружина брата, братова
Невіхна	невістка
Невмінько́во	ненароком, ненавмисне
Невміятниця	така, що нічого не вміє
Невольно	не можна, не дозволено
Невтельопний	непутящий
Недалекий	дурний
Недивний	непоказний
Недовірок	ренегат, відступник, зрадник свого народу
Недомотаний	придуркуватий, недостатньо розумний
Незабавка	незабаром
Незви́клий	незвичайний
Нездалий	негодящий
Ней	нехай
Неля	не можна
Нема мочі	нема сили
Немо́ж	неможливо
Неназдога́дь	непомітно
Нензний	нужденний
Ненужлі	ніж, чим
Ненько	тато
Неньо	тато
Не́ньо, ненько	тато, татко
Неошатно	бідно, не нарядно, обідрано
Непосидкий	непосидючий
Непутниця	така, що нічого до пуття не зробить
Несідка	квочка
Неска	сьогодні
Неспособна	тут не здатна для роботи
Несуций	нездатний
Нетлеханя	ледащиця
Нетрудний	<a href="https://proridne.net/Українська міфологія/Чорт.html">чорт</a>
Нетяга	голота, бідняк, що не має ні тягла, ні домівки
Неукий	невчений
Нехарапутний	непоказний і непутящий; не такий, як треба
Нехарний	відворотний, противний
Нешній	сьогоднішній
Ниґда, нигда	ніколи
Низ	Запорозька Січ
Никус	нічого
Ниніка	нині, сьогодні
Нинька	сьогодні
Ниньки	тепер, зараз, сьогодні
Нирну	пірну
Ниська	сьогодні
Нич	нічого
Ні	мене
Ні’ка	ніяка
Нівро́ток	бідняк
Нігда	ніколи
Нігде не встав	ніколи не піднявся
Нігди	ніколи
Ніж	поки
Ніже	поки
Ніжень	поки
Ні́жка	низка
Ніклея	нечупара, ледащиця
Нікогогіч	нікого-нікого
Нім	поки, ледь
Ніт	ні, нема, немає
Ніц	цілком, зовсім; нічого;
Ніц а ніц	анічогісінько
Ніч	нічого
Нічка четвертенька	вночі під четвер
Нічогі́ч	нічогісінько
Нічогогі́ч	нічогісінько
Нічогоріч	нічогісінько
Но	тільки, лише, але
Новена	звістка
Новинка	газета
Ногавиці	сукняні штани
Ножик-цизорик	складаний ножик
Нора́	нора; джерело води
Нори́чка	джерельце
Норцове пиво	тут молоде, не готове ще для вживання пиво
Нотаруш	нотаріус
Но́ша	одяг
Нуждува́тися	журитися, нудитися, сумувати
Нужки	ніжки, ноги
Нужний	нужденний, обдертий
Ну́рка штрикнути	пірнути
Ньїж мі	чим (ніж) мені, а також майже
Ньов	нею
Ню	неї, її
Нюм	поки
Ня	мене; ні
Няй	нехай
Няньо	тато, батько
Оба	обидва
Обаринець	бублик
Обвахта	гауптвахта
Обву	Об’ єднання бувших вояків-українців
Обвуа	Об’єднання бувших вояків-українців в Америці
Обглодана	обдерта
Обгорати	зорати
Оберліхт	кватирка у вікні для провітрювання
Обершт	полковник
Обзор́ини	оглядини
Обібрати	взятися, стати, згодитися на якусь справу
Обід	поминки або святкова учта
Обідниця	та, що покривдила, кривдниця
Обі́здритися	озирнутись
Обійстя	господарство; двір
Обіска́ти	шукати на голові паразитів
Обіч	схил
Облавок	борт судна, галери
Облаз	1) крута гора, скеля; 2) тут обманна позика, обманна лотерея
Облак	вікно
Облапити	обняти
Облачок	вікно, віконце
Облектися	одягтися
Облікати	одягати
Облок	вікно
Облудний	брехливий; тут ошуканий, обдурений
Обме́тиця	рештки борошна, які обмітають з жорен
Обмітний	замітний
Оболок	вікно
Оболона	віконце
Оболонь	низьке лугове місце
Оболоня	вікно; синє небо; низькі луки
Обо́ра	господарське подвір’я, загороджене місце для скоту, обійстя, огороджене подвір’я
Оборіжець (здрібн. від оборіг)	повітка на чотирьох стовпах для зберігання сіна, збіжжя і т. ін
Оботи́тися	піклуватися, турбуватися
Обрадувати	пограбувати
Обротя́нка	вуздечка
Обрус	скатертина, рушник
Обсилити	1. обняти. 2.обв’язати
Обсмотри́ти	обмацати
Обставатися	залишатися
Обушок щирозлотний	чекан, ручна золота зброя
Обха́яти	привести до ладу
Обхі́дниця	служниця, яка доглядає тяжкохворого
Обходи́ти	доглядати
Обшаря	обійстя
Обшацовати	оцінити, скласти ціну
Обшкалюва́ти	обдряпати
Овкуг	Організація вищих кляс українських гімназій ( розповсюджували нелегальну літературу, проводили свята «стрілецьких могил», збирали гроші на бойовий фонд УВО, у 1924 р. видала журнал «Метеор»)
Овріяш	великан, велетень
Огнинець	чортяка
Огрудечок	горідчик, городчик
Оґін	хвіст
Од дуба до дуба	від човна до човна
Ода’я	належна комусь велика ділянка землі
Одамашка	адамашка
Одвах	гауптвахта
Одводити	відмовляти, відговорювати
Одгрібатися	відпиратися
Оде	он, ось, ось тут
Оделія	одяг
Оденки	сходини заміжніх жінок вдень для виконання ручних робіт
Оде́нок	вистелене дошками горище хліва; стіжок снопів
Оди	ось
Одкаль	звідки
Одкуда	звідки
Однажди	одного разу
Одомаш	почастунок
Одпочати	відпочити, відпочивати
Одробина	крихта, крапля
Одсіль	звідси
Одталанькуватися	відмовлятися, відпиратися
Одфіглюватися	оджартуватися
Ожелю́д	жолудь
Ожолуди	жолуддя
Ожулю́д	жолудь
О́зде	ось тут
Озерниця	озерна, лиманна сіль
Озми́тм	взяти
Окі́п	насипаний горбок, шанець, рів
Окличен	відомий, знаний далеко
О́ко	міра об’єму хмільних напоїв, що дорівнює 1—1,5 л; пляшка такої місткості
Оковита	горілка
Околичні	навколишні
Околі́т	сніп соломи
Околот	оббитий, обмолочений сніп, сніп соломи
Околотник	солом’яний кошик для збіжжя
Окоман	тут економ-каратель
Окомон	економ
Окомун	економ
Окописько	єврейський цвинтар
Окраєчка	жіночий поясок
Окрент	пароплав
Окроме	окремо
Округ оступати	оточувати, окружати
Оліти	воліти, хотіли
Омбрела	парасоля
Омітати	віяти
Онгар	угорець; тут: виходець з Австро-Угорщини, який емігрував до Америки
Оно	тільки
Оочсу	Організація оборони чотирьох свобод України в США
Оп’ять	знову
Опалки	торба, з якої годували коней
Опанча́	епанча, рід верхньої одежі; погана одежа з епанчі
Опанчи́на	епанча, рід верхньої одежі; погана одежа з епанчі
Опаньчи́на	рід верхнього одягу
Опара́т	верхнє вбрання священика, яке вдягається під час богослужіння
Опарати	вбрання священика під час богослужіння
Опасатися	підперезатися
Опачина	велике весло на гребному судні, яким гребли кілька чоловік разом
Опідлити	образити й принизити людину («Колгоспник
Опілка	торба, з якої годували коней
Оплі́т	обгороджений плотом стіжок; площа, з якої можна накосити сіна
Оплоші́ти	ослабнути, затихнути, заспокоїтися, посмирніти
Опочинок	відпочинок
Опри́шок	народний месник; розбійник, злодій
Опроважа́ти	освячувати
Опрошкувати	іти навпростець
О́пуд	опудало
Оранда	шинок
Ордів	бочка
Ордона́нс	денщик, або ординарець, в офіцера
Орек	земельний маєток
Оренда	шинок
Орій	орач
Орнаута	арнаутка, сорт ярої пшениці
Орсаг	держава
Ору́да	закуплені; придбані речі
Ору́дувати	облаштовувати справу; придбати щось
Оружіє	зброя
О́рчик	дерев’яний валок, до якого прикріплюють посторонки в упряжці
Ос(Ь)Мина	міра землі
Осавула	поміщицький прикажчик, наглядач за кріпаками або наймитами, а також офіцерський чин у козацькому війську
Осадити	оточити, обложити
Осе́льниця	гусениця
Осипка	зернові відходи
Оскілько	оскільки
Ослободи́ти	звільнити, визволити
Ослон	смертне ложе
Осмотряти	дивитися, оглядати
Осталець	останній сніп на ниві
Остальні	інші
Ости	остюки
Осторо́га	охорона, сторожа, варта
Остра стрільниця	стрілецькі змагання
О́стрий	жвавий, енергійний
Остри́тися	різко, погрозливо говорити
Остріва́	кілок зі сучками для просушування скошеної трави
Острішок	стріха
О́стро	сердито, зі злістю
Остров	кілок з сучками, на якому просушують траву
Остроги	шпори
Острожні	тюремні
Оступати	облягати, оточувати
Осьмак	старовинна монета в чотири копійки, вісім грошів
Отаман	військовий керівник; тут керівник козаків і озброєних селян (військовий отаман), а також старший над групою селян у поміщика
Отарницайте	осідлайте
Откаль	звідки
О́тпуст	храмове свято
Отріб	нутрощі з живота
Отталь преч	звідти геть
Оттуда	звідти
Оун	Організація українських націоналістів
Оунсд	Організація українських націоналістів самостійників-державників.
Офензива	наступ
Оферма	ледащо
Охабити	лишати, покидати, охаяти
Охабляти	лишати, покидати
Охапок	оберемок
Охвала	похвала
Охотник	доброволець; викликати на охотника — набирати добровольців, охочих; охотне військо — добровольці, мисливець
Охри́нути	опритомніти
Очерт	коло
Очертом сідати	сідати колом
Очкур	шнурок або ремінь для підперізування штанів
Очоловічитися	оженитися
Ощип’я	корж
Ощипля	великий корж
Ощипок	пласка хлібина, великий корж
П’ядь	старовинна міра довжини, приблизно одна п’ята метра
П’ятойка	п’ятниця
П’яц	ринок, майдан
Павіз	мари
Павлин	павич
Падимент	підлога
Па́дочку	простонародне звертання у гуцулів
Паздеро	костриця
Паздір’я	костриця
Па́зити	пильнувати, стерегти
Пак	потім; далі
Па́ка	великий ящик
Пакташа	військова сумка
Пал	впав
Паленка	горілка
Паленя	корж
Палінка	горілка
Палонка	паланка; тут укріплений частоколом і земляним валом населений пункт
Пальонка	горілка
Палюнка	горілка
Пам’ятни́к	ворожбит
Пандлик	клапоть
Пантлик	стрічка
Пантликар	продавець дівочих стрічок
Пантрати	стерегти
Пантрува́ти	стежити, пильнувати, слідкувати, підстерігати, стерегти
Папаха	пачка сушеного листового тютюну
Папуш, папуша	пачка висушених тютюнових листків, також пачка грошей
Папуша	пачка сушеного листового тютюну
Парадний	гарний, гордовитий, пишний
Парастас	панахида
Парна	подушка, перина
Парно	гаряче
Паровії	селяни, які мали пару волів
Парувати	готувати
Парце́ля	невелика ділянка землі
Пас	паспорт
Пасак	пастух
Пасерб	у сім’ї чоловіків син
Пасеці	пасеться
Пасільни́к	пасіка
Пасія	злість
Пасмо	30 ниток
Пасоля	квасоля
Пастівни́к	пасовище
Пастушка	пасіння худоби
Пательня	сковорідка
Пати́к	палиця, шматок дерева, дрючок, ломака, поліно
Патичо́к	палиця, паличка
Патрафіль	єпітрахіль
Патрахі́ль	покривало, яким піп покриває голову віруючого під час сповіді
Патрити	дивитись
Патроль	патруль
Патрон	тут портрет
Па́хати	нюхати
Пахоля	немовля
Паци́ти	зазнати чогось небажаного, поганого; пережити щось небажане і неприємне
Пацьори	намисто
Пацьо́рка	намистина
Пацю́к	порося, свиня, кабан
Паця	порося
Паче	краще, а також дужче, сильніше
Пачмаги	штани із домотканого полотна
Паша	турецький вельможа, великий пан
Пашня	зерно
Пе(й)да	плата, платня, заробіток
Пекна	хороша, красива
Пелена	подол сорочки
Пеленки́	пелюшки
Пелехатий	волохатий
Пенєдзи	гроші
Пенєжи	гроші
Пеньґо	угорська грошова одиниця
Пе́рвий брат	двоюрідний брат
Переверечи	перекинути
Переверла	перекинула
Переверни	перекинути
Переверчи	перекинути
Переви́діти	передбачити
Перевити	переповити
Перевитити	перевершити
Перегодом	невдовзі
Перегодя	незабаром, невдовзі, за деякий час
Перегрозки	переїди
Передднина	світанок
Передерійка	перекупка
Передснічний	той, що був позаминулого вечора
Передтогідний	позаторішній
Переїхати	переїжджати
Переки́нути(ся)	перевтілити(сь); впасти
Перекицкатися	робити сальто, перевертатися через голову
Перекоси	покоси
Перекрій	місяць у другій чверті
Переметуватися	перекидатися
Перемишне вікно	вікно напроти печі
Перепу́дитися	перелякатися
Переріж	місяць в другій чверті
Перерубка	половина бесаг
Перестати	перестріти; перейти когось з недобрим наміром, перейти когось на дорозі та зупинити його
Перечеряти	поміняти
Пере́читися	сперечатись
Перечувати	перепитувати, довідуватися
Перпічки	ринки, кастрюлі, сковороди
Персть	земля
Перський	спритний, бистрий
Пертурбації	раптові небажані зміни в тій чи іншій спільноті людей, які йдуть одна за одною
Перце́	здрібніле від «перо»
Перчатки	рукавички
Пе́рший раз	спочатку
Песя́	щеня
Песячка	собачий послід
Петек	верхня одежина з домотканого сукна, верхня вовняна одежа
Петелька	мотуз, вірьовка
Петечина	верхній одяг з грубого сукна
Печи	пекти
Печина	перегоріла глиняна замазка в печі
Пе́чисько	місце, де колись була піч, руїни з печі
Пешка	стежка
Пєц	піч
Пиват	п’є
Пивни́ця	підвал, погріб, винний склеп, льох
Пизи	галушки
Пил	тирса з-під пили
Пиливня	стодола
Пилипова́н	старообрядець
Пилува́ти(ся)	квапити(ся)
Пильний	невідкладний, потрібний, спішний
Пиля	біля
Пиняво	мляво
Пипка	люлька
Пи́рга	стара потворна людина
Пироги	вареники
Писар військовий	начальник військової канцелярії: тут — канцелярії гетьмана
Писок	рот, губи, морда
Питель	сито на млині для відсіювання (питлювання) муки
Питух	півень
Пищалка	сопілка
Пищаль	старовинна вогнепальна зброя, довга і важка рушниця, яка заряджалася з дула
Пищиська	лице, губи (зневажливо)
Пі́вкати	вищати, пищати
Півметра	півцентнера
Півничок	глиняний кухлик
Півтретя	два з половиною
Півчварта	три з половиною
Півчвартаста	триста п’ятдесят
Півшести	п’ять з половиною, а також три
Пігулка	таблетка
Піґліці	різновид ковбаси
Під	горище (род. відм. поду)
Під голов’я	під голови, в узголів’я
Підбива́ти	готувати їжу
Підверли	підкинули
Піддах	піддашшя, господарська прибудова
Піді́здрити (підо́здрити)	підглянути
Підковиряти	підколупати
Підкуси́ти	спокусити
Підмага́ти	доростати, дозрівати (про вік людини)
Підми́ти	зловити
Підмі́т	невелика господарська прибудова
Підмі́тувати	підкидати
Піднайти	спокусити (жінку)
Підоздріти	піддивитися, підглянути
Підойми́ти	підняти
Підпалок	великий круглий корж
Підпеньки	опеньки
Підполоч	горизонтальна виїмка
Підси́пати	покласти яйця під квочку
Підсіння	ґанок
Підтоки	колодка, що з’єднує передню частину воза із задньою
Підтрою́дити	підмовити, підбурити
Пі́зьма	вороже ставлення до когось
Піймити	піймати, зловити,пообіцяти
Пікінери	частини російської армії, озброєні піками
Піл	дерев'яні нари в українській хаті, що розміщувались вздовж задньої стінки між піччю та боковою стіною, збитий з дощок поміст на чотирьох кілках, де влаштовували постіль
Пінована пляшка	міцне, піноване вино, особлива міцна горілка
Пінязи	гроші
Пінязі	гроші
Пінязь	гріш
Піпа	люлька
Пірчина	пір’їна
Пірчити	бити, лупцювати
Пітаєці	питається
Піхана	товчена в ступі
Піхту́рка	стежка
Піхурка	стежка
Пішник	стежка
Піщалкош	музикант
Пі́яти	співати, кукурікати
Плави́ння	колода і гілки, принесені повінню
Плаєчок	гірська стежка
Плай	чиста від лісу лука в горах
Планетник	ворожбит-ясновидець
Планий	поганий, злий
Планно	сумно
Плат	хустина, хустка
Платина	хустина
Плати́нка	хустинка, носовичок
Платно	полотно
Плаття	спідній одяг, білизна
Плахта	рядно
Плахту́ра	рядно
Плаца	плата
Плебан	піп
Плебан, плєбан	священик
Плекати	годувати дитину груддю
Пленкач	теслярська сокира
Плескати	говорити зайве
Плече	годує груддю (дитину)
Пливати	плавати
Плигать	стрибати
Плигнути	стрибнути
Пліт	тин, огорожа
Пло́ва	злива
Плотня	теслярня
Плохо	погано
Плуганитися	волочитися
Пльо́нтир	поверх
Пльонтр	поверх
Пльонтро	поверх
Плякатися	годуватися материнським молоком, ссати матір
Пляц	місце, ділянка
Пняк	пень
По дуткові	тут: по дукатові
Побанувати	пожалкувати, пожуритися
Побережни́к	лісник
Побивати	покривати дах ґонтою
Побиратися	бідувати, жебрати
Побідити	покривдити
Побішниця	дерев’яна ніжка в ліжку
Поблагодарить	подякувати
Побожити	взяти від когось клятву
Побочкати	поцілувати
Побратим	коханець
Побусурманитися	прийняти магометанство, зрадити і стати на бік турецько-татарських загарбників
Повала	стеля
Повважай	приглянь
Пове́рх	понад
Повеснувати	провести весняні посівні роботи в полі або на городі
Пови́діти	побачити
Повимотувати	повикидати
Повита́тись	привітатись
Повитуха	баба, що приймала пологи
Повідати	говорити, розповісти, оповідати, розказувати
Повіємо	прядиво
Пові́з	екіпаж, візок
Пові́смо	прядиво, пряжа
Повісти	сказати
Повітка	піддашшя; примішення для тварин
По́вниця	дарування грошей молодим на весіллі; момент весілля, коли гості обдаровують молодих
Повоз	віз, хура
Повозка	віз
Повшехний	загальний
Погар	келих, склянка
Погарець	келих, шклянка
Погарик	кєлишок
Погарнує	потанцює
Поглипати	поглядати, позирати
Погодити	почекати
Погончений	покритий ґонтою (дах)
Пого́стити	зазнати чогось
Пограблено	згребено
Погріб	похорон, похорони
Под(ь)ме	ходімо
Подбой	дах
Подвоїти	лицемірно повестися
Подина	низька місцевість, яка іноді заливається водою, низька долина
Поді́бний	гарний
Подобна	гарна
Подовий	той, що на горищі
Подо́к	місце у млині, де встановлені жорна; горище
Подо́ля	долина
Подорожни́к	спориш
По́дря	горище над стайнею
Подуркати	постукати
Подушитися	міцно обнятися
Подушне	податок, подушний податок
Подь	ходи
Подь же	ходи но
Подяний	той, що на горищі
Поєдинки	ті, що мали по одному волу
Поєди́нче	окремо, роздільно
Пожень	пожени
Пожички	порічки
Пожмакати	попрати
Позадічко	залишки зерна, що зосталось в соломі
Позапря́тувати	поприбирати
Позарився	спокусився
Позаютро	післязавтра
Позбирати	вбрати, одягнути
Позвідатися	запитати, попитатися
Поздоровитися	привітатися
Позерати	дивитися
Позирати	дивитися
Позна	непорядок
Позривати якорі з турецької каторги	зірвати з якорів галеру, до якої турецькі феодали приковували невільників
Поїмати	зловити
Пой	іди, прийди
Показати рака	втекти
Показитися	побитися, поламатися
По́клад	палуба
Поклопкати	постукати
Покля	поки
Покмітити	помітити
Поковтати	постукати
Покопали	побили
Покравати	краяти, різати
Покрадеми	крадькома
Покрадоми	крадькома
Покрадьки	крадькома
Покрасіти	похорошіти
Покровена	покрита
Покровець	домоткана ковдра, рядно
Покропив’яник	байстрюк
Покунтетува́тися	задовольнитися
Поку́татися	позбутися
Поку́шати	покуштувати
Полакомитися	спокуситися
Поламнути хрест	зрадити, порушити присягу
Политики	подарунки
Поличкува́ти	бити по лиці
Поли́чник	ляпас
Полівити	поступитися, пом’якшити свою позицію, попустити, полегшати (при недузі)
Полі́г	скошена трава, рівне низьке місце коло річки; тут зелений покіс, зелена трава
Політок	урожайний рік на якусь культуру, наприклад, політок на картофлі
Полкові і сотенні города	міста, в яких знаходилися військово-адміністративні і економічні центри полків і сотень
Полови́к	шуліка, яструб
Половиця	половина
Половник	приміщення для соломи й полови
Полокати	мити, полоскати, прати
Полон	здобич
Полонина	гірська рівнина, яка знаходиться вище лісової смуги; звичайно гірське пасовисько в Карпатах, високогірне пасовище
Полотенце	рушник
Полтів	сало, солонина
Полу́бічок	велика бочка
Полуда	більмо, засліплення очей
Полу́дне	південь
Полу́днє	полудень
Польо́вання	полювання
Польовати	хліборобити
Польовий	панський економ, наглядач в полі за кріпаками і наймитами
Польовниці	суниці
Полюбитися	сподобатися
Полювати	хліборобити
Полярос	гаманець
Полятички	подарунки
Помалюськи	поволі
Пома́на	вечеря, яку несли у різдвяний вечір сусідам і близьким; дарунки за упокій померлого
Поматися	пообіцяти
Помінити	пообіцяти
Помінитися	пообіцяти
Помі́р	велика смертність, пошесть, мор
Помняцкати	пом’яти
Помочи́	помогти
Помуцувати	попробувати на чомусь силу
Понаглятися	поспішати
Понажено та через мечу положено	порубано в рукопашному бою
Понамітувати	понакидати
Пониська	понині
Поніж	пристрій, за допомогою якого, наступаючи ногою, колишуть колиску або тчуть на верстаті
Поняти	взяти, піймати
Понятися	побратися
Поняхати	покинути
Пообіськати	пошукати паразитів у когось на голові
Попахати	понюхати
Попилуватися	поквапитися попри них, понад ними
Попиняти	посварити
Попісні́ти	спохмурніти
По́плавець	пліт (засіб пересування по воді)
Поплекати	погодувати материнським молоком
Попозирати	подивитися
Попратати	поприбирати
Попри́	понад
Попригуртовувати	поприв’язувати
Попризиратися	придивитися
Попризиркуватися	придивитися
Поприкаш	м’ясна страва з перцем
Попру́жка	жіночий пояс з грубої кольорової пряжі; крайка
Попря́тати	прибрати
Попуцувати	почистити до блиску
Поражати	радити
Пораятися	поратися
Поре́кло	прізвище
Поренче	бильце ліжка
Порєдок	порядок, лад
Пород, породи	пологи
Пороздівати	порозтрачувати
Порозпукуваний	порозтріскуваний
Порох, порохи́	пилюка
По́рсти	кинутися, взятися до чогось
Портки	полотняні штани
Портяниці	полотняні штани
Порція	чарка, тут: податок
Посеквестровати	переписати з метою конфіскації
Посеквестувати	провести опис майна
Послідниця	жниця, що вижинає останній сніп
Посмотрити	помацати
Поснічати	постити
Поспацируватися	прогулятися, пройтися
Постав	сукно, покривало
Постадниця	дівчина, яка грає на обжинках головну роль
Постає(м, н)не	платня за постій коней
Постановляти (вина)	поставити на стіл, замовити вина
Постара́ти	придбати, набути
Постать	ділянка, частина поля
Постатька	ділянка, частина поля
Постерунковий	жандарм з постерунку
Постеру́нок	жандармський пост за Польщі
Посторонки	вірьовки, якими прикріплювалася упряж до орчиків
Посторцювати	поставити сторч
Поструг	риба форель
Посьцівка	постіль
Потала	знищення
Пота́ти	(перен.) розтанути, зникнути
Пота́хнути	осісти
Потермосати	потрусити, похитати, потрясти
Потік	струмок
Потічок	струмок
Потолок	стеля
Потопити	чкурнути, швидко піти
Поторгатися	порватися
Пото́чина	струмок
Потрав	страва
Потрава	страва
Потравитися	поїсти
Потра́фити	зуміти, потрапити
Потреба	битва, бій
Потрі́бний	працьовитий, роботящий, енергійний
Потряска	танець (його назва)
Поть	наказова форма від «іти»
По́тя	пташеня, пташка
Потягати	бути спроможним
По́тятко	пташеня, пташечка, качатко
Потячий	пташиний
Похва	піхви (для шаблі)
Походка	хода
Похожа́лий	старший, досвідчений
Поцоркати	побрязкати
Поцотікати	погойдати
Поче́сне	дарунки, що їх підносить молода під час весілля рідні молодого; момент весільного обряду, коли обдаровують молодих
Починати	чинити, діяти
Починок	веретено з напряденою пряжею
Почитати	шанувати
Почкай	почекай
По́чогом	волоком
Почтувати	пригощати
Пошкобортати	поколупатися
Пошкромити	поранити, поцарапати
Пошпотатися	спіткнутися
Пошти	майже
Пощебати	сколоти, поколоти
Пощибати	позбивати
Пощо	нащо
Поюдити людей	внести між люди незгоду
Появляця	з’являтися
Правдитися	перечитися
Пра́вий	прямий, простий
Правитися	поправлятися, набирати ваги
Правіл	робив
Право	(напрямок) просто
Правцювати	іти навпростець
Пражи́на	хворостина, жердина; міра довжини
Празник	свято
Прайник	дерев’яний брусок з рубцями для вибивання білизни при пранні
Прало	кам’яна плита при березі річки, на якій жінки прали білизну
Праник	дерев’яний гладенький валок (лопатка) для вибивання білизни під час прання, дерев’яний брусок з рубцями для вибивання білизни при пранні
Працівний	стомлений працею
Прач	праник з дерева для прання
Прачем опанувала	прачем окатувала, побила
Прачка	місце на річці, де прали
Прашівник	сапалник
Прашува́ти	сапати просапну культуру
Праща́та	праправнуки, діти правнуків, нащадки
Пращеня́та	діти пращат
Пребіц	прибити
Предложить	запропонувати
Преж	через
През	через
Презент	президент
Препина́ція	корчма
Преступити закон	порушити закон
Преступитися	розступитися
Прецінь	власне
Преч	геть, збоку
Прешиц	перешити
Прибага́ти	придумувати
Приба́гнути	забажати
Привез	привіз
Привій	ремінь або шнурок для прив’язування чогось
Пригінчий	наглядач
Пригінший	наглядач над женцями
Пригісне	бенкетування на честь повернення додому когось рідного
Пригребиця	погрібниця, передня частина льоху
Придзі́нькуватися	привітатися
Приїзжий	наглядач на панщині
Приїхати	приїжджати
Прийдена воля	воля, свобода, що вже прийшла, настала
Прийдесь	доведеться, прийдеться
Прийменник	ворожбит
Прийми́ти	прийняти
Прийти́ зна́ти	відвідати
Приказувати	розказувати, розповідати
Прикімарив	задрімав
Приключка	привід
Приклякнути	стати навколішки
Прикучува́ти	привести
Прилагодити	зробити
Прилежати	умерти
Прилиґнути	проковтнути
Примар	урядовець, волосний старшина
Примарія	волосне правління
Примикати	глушити (вуха)
Примівка	тут: ворожка
Примівни́к	ворожбит, знахар
Примівниця	ворожка
Прине́жда	лиха пригода, лиха година
Приняти кайданами	прив’язати кайданами, прип’яти
Прип’ятися	прив’язатися
Припасувати	примірити
Припатрятися	придивлятися
Припецок	припічок
Припіл	пола, згорнута так, щоб у неї щось класти
Припрятувати	прибирати
Приректи	поклястися
Пририхтовати	прилагодити
Присили́ти	прив’язати
Присішки	стремена
Прислопити	придавати
Прислянка	лежанка
Присоглашати	запрошувати
При́спа	призьба, невисокий насип уздовж стін хати знадвору
Приспо́дня	пекло
Пристайка	жінка або дівчина, до якої можна пристати в прийми
Пристара́ти	придбати
Приста́ти	погодитись
Пристрітити	зустріти
Присяжний	довірена особа в старі часи
Пританожило	припекло
Притворитися	прикинутися
Притика	палиця, що прикріпляє ярмо до дишла
Притиче	прибуде
Притринижитися	пристати, приєднатися
Прихі́д	дохід
Причекнути	присісти
Причинити	приточити, доточити
Причинувата	причинна, тобто така, що з горя великого з розуму зійшла
Приялося	прийнялося
Прияти	прийняти
Прияти дяку	набратися охоти
Пріде	прийде
Прікопчана	прикріплена
Прісь	народна форма від «prísť» прийди
Прічка	мила, наречена
Прічки	геть
Пробудиласи	прокинулася
Пробу́тчик	той, з ким приємно проводити час
Провізор	старший церковний братчик
Провізорично	поверхово (щось обстежити чи досліджувати)
Провізорія	чиновники з суду
Прогнав	послав
Прозвище	прізвище
Пронір	потік, струмок
Прости́б(і, іг)	дякую, спасибі
Простибува́ти	дякувати
Простогалина	галявина
Прохватитися	прокинутися від сну
Процесія	церковна корогва
Процесуватися	судитися в суді
Прочутити	привести когось до свідомості після непритомності
Прочути́тися	очуняти
Прошка́питися	провинитися, проштрафитися
Прошкувати	ходити инавпростець
Прошума́тися	прокинутись від сну
Прощений би	примовка на знак пошани при згадці про покійника
Пругінець	грань, кайма
Прудкувати	іти водою, не знаючи броду
Прус	Пруссія
Пручітай	прочитай
Прядки	вечорниці
Прятати	збирати щось
Пряч	геть
Пряшни́к	веретено з напряденими нитками
Псик	песик
Псиня	щеня
Псота	втрата, шкода
Пструг	форель
Псячка	собачий кал
Публіка	осуд, поговір
Публікат	оголошення
Публіки	оголошення, повідомлення новин
Пугурець	пугач
Пуд	російська міра ваги, 16 кг
Пуде́лко	коробочка
Пудж(а, я)ти	лякати
Пудлові сани	мальовані закриті сани
Пу́дно	страшно, лячно
Пу́ж(а, я)ти	лякати
Пу́жално	руків’я батога
Пукалка	рушниця
Пу́кало	(зневажл.) рушниця
Пу́кати	стукати; розриватися; тріскати, лопатися
Пукнути	тріснути
Пулькатий	вирячкуватий
Пуля́рець	гаманець
Пуляру(с, ш)	гаманець
Пуля́рчик	гаманець
Пун	Провід українських націоналістів
Пу́рця показати	втерти комусь носа, зробити щось особливе
Пуслань	посаг
Пуст ня вну	пусти мене до хати
Пустай	пустир
Пустопаш	без пастуха; тут без прив’язу і нагляду
Пусце	пустіть
Путаки	пута
Путати	лякати
Путник	подорожній
Пу́тня	відро
Пух	сопух, поганий запах, дух
Пу́цар	чистильник взуття
Пуцува́ти	чистити (коня, взуття тощо), чистити до блиску, чистити, терти
Пу́шка	гвинтівка, рушниця
Пушкар	стрілець, мисливець
Пуще	гірше
Пущий	гірший
Раб(о, у)вати	грабувати
Рабин	віровчитель і керівник єврейської громади
Раз	зовсім
Райбало	прало
Райбати	прати
Райзовати	подорожувати
Райтувати	їхати верхи на коні
Рамат	ганчірка
Рама́ття	дрантя
Рампасовий	сап’яновий
Ранди	шмаття
Рантухова (сорочка)	з фабричного полотна
Раньдочки	шмаття, білизна
Расовий	породистий
Ратище	спис
Раубшіцер	браконьєр
Рафа	залізна шина на колесі у возі
Рахуба	число
Ребро	гірське пасмо, що круто обривається
Реведони	ревізори
Ревере́нда	ряса
Ре́вне	дуже гірко, дуже жалібно
Регімент	полк, військова частина
Регруци	рекрути
Реґіме́нт	полк найманого війська
Резколеця	розколеться
Рейбати	прати
Рейвах	безлад
Рейза	мандрівка, подорож
Реймент	полк, військова частина
Рейстровий козак	реєстровий козак, тобто занесений до реєстру, списку, введеного польськими королями в XVI — XVII ст. на Україні
Рейтар	найманий іноземний солдат-кавалерист
Рекгемент	полк, військова частина
Реклик	піджак з грубої шерсті
Рекоме	диван, софа
Ремезувати	робити міцним
Ре́тівка	дерев’яна посудина
Рехлик	куртка, піджак
Рехтшав	праворуч
Речи	говорити
Речине́ць	строк
Решт	арешт, тюрма
Рззз	Референтура зовнішніх закордонних зв’язків
Рибалка	риболовля
Рибнік	озеро
Риж	рис
Ри́нка	кругла череп’яна посудина, макітра, каструля, різновид горщика
Ри́нський	народна назва австрійської грошової одиниці крони, австрійська грошова одиниця флорин, монета вартістю близько карбованця
Ри́па	яр
Риска́ль	заступ
Ритвини	ридвани
Ритиченьки	ткацький прилад
Ритю бити	копитами бити
Рихтувати	лаштувати
Рихтува́ти(ся)	організувати(ся), готувати(ся); лагодити, злагоджувати
Рихтуватися	збиратися
Рихтує	готує
Різа	ділянка поля, лісу
Різанки	тирса з-під пили
Різувати	спускати з гори вниз колоди
Рікля	старовинний жіночий одяг
Ріпа	картопля
Ріпак	реп’ях
Ріска	гілляка
Річа	річка
Річник	строкар на рік
Ріща	хворост
Ріщя	обрубане з дерева велике гілля
Робак, робака	роботящий чоловік
Робі́тний	роботящий, працьовитий
Роваш	рахунок
Ровінь	рівнина
Ровіньця	галявина
Ровта	рота, військовий загін; тут жандармська військова частина
Рогантина	тюль
Рогожовая опанчина	погана одежа, одежа з рогожі
Родитися	родичатися
Ро́дичі	батьки
Родовитий	вроджений
Рожина	листя рожі
Розбіглиси	розбіглися
Розболіка́ти	роздягати
Розболочи́ти(ся)	роздягнути(ся)
Розбринзити	розтріпати
Розвита́тись	розпрощатись
Розвити	розгорнути
Розвіта́тися	розпрощатися
Розволіка́тися	роздягатись
Розга	різка
Розгорнутий	роздягнутий (без верхнього одягу)
Розгорну́тися	роздягнутись
Розгортатися	скидати з себе верхній одяг
Роздолля	широка низька долина
Роздякуватися	розпрощатися
Розжорни́ти	розмолоти
Ро́зказ	наказ, команда, дозвіл, розпорядження
Розка́зувати	наказувати, розпоряджатись, командувати
Розминути	розтратити (гроші)
Розпарцелюва́ти	розділити земельну площу на ділянки
Розпасіюватися	розлютитися, розізлитися
Розпізнатися	тут зазнати лиха, перетерпіти
Розпі́рити	розчепірити
Розполонити	звільнити
Розсипа́тися	упадати
Розсі́стися	тріснути і розвалитися
Розталюва́ти	розмістити
Розтірятися	розгубитися
Розчеркотати	розлетіти
Розшолопати	зрозуміти
Розшпінькати	розстебнути
Розщибатися	боротися
Рокови́й	річний
Роковий день	день, що буває раз у рік, річне свято
Романсува́ти	мати любовний зв’язок
Ромото́к	шматина-пов’язка
Ропцак	рюкзак, заплічний мішок
Роска́ль	риска́ль, заступ, лопата
Росохате дерево	дерево, стовбур якого розділяється вгорі на два-три стовбури
Росоха́тий	розлогий
Ростопира	роззява
Ростояніє	віддаль
Рота жінок	група, гурт жінок
Ро́чник	термін
Роштиї	грати
Рубатка	шматина
Рубатки	дрантя
Рубаття	дрантя
Руга	церковна або попівська земля
Ружжо	рушниця
Ружина	рушниця, зброя
Ружічка	троянда
Ружний	рожевий
Рукав’янка	вишивана жіноча сорочка з довгими рукавами
Руковати (на війну)	рушати, виступати
Рум	ром
Румене	рум’яне
Румені	рум’яною
Рундзя	дрантя
Ру́нтати	рухати
Рунтатися	борсатися
Руп	Революційна українська партія
Рупа	яма для картоплі
Ру́пцак	наплічник, рюкзак, заплічний мішок
Рупцачина	рюкзак, заплічний мішок
Ру́ти (рую, руєш)	ревти, рикати
Рутяти	кидати
Ручина	сплетені руки
Ряд (за рядом)	порядок; поспіль
Рядо́к	низка (про намисто)
Рядчик	підрядчик, розпорядник
Ряжина	погана одежа, одежа з рядна
Ряжиня	погана одежа, одежа з рядна
Рянда	шматина
Ряндочки	шмаття, білизна
Ряндюх	ганчірник
Сабатушка	вид горілки за Польщі
Сабаш	єврейське свято
Савтир	псалтир
Савтиря	псалтир
Сагадов	заїзд
Саджавка	копанка
Сак	сіть
Салатура	мочар
Сала́ш	отара, місце утримання овець на полонині
Салтан	султан; тут монарх, турецький султан
Са́ля	зала
Саме головне	найголовніше
Самопал	старовинна рушниця, пищаль
Самосад	тютюн, вирощений на власному городі курця
Самотіжно	самотужки
Самотока	пристрій для змотування ниток
Самоту́жка	ручні санки
Самотяж	самотужки
Сановий бич	сучий син
Сапожник	швець
Сара	халява в чоботі
Сара́ка	(жін.) бідолаха, бідний, нещасний, бідолашний
Сара́ку	(чол.) бідняк, бідолаха
Сарахман	бідолаха
Сарда́к	гуцульська коротка верхня прикрашена коротка одежина (куртка) з домотканого сукна
Сачок	тепла куртка
Сашав	убрання
Свада	сварка
Свайба	весілля
Свальба	весілля
Свекра	свекруха
Свершо́к	цвіркун
Свидина	кизил
Свиня́к	послід свині
Свитка	сукня
Свірки	ялини
Світлойка	світлиця
Світовая зоря	ранкова зоря
Свому	своєму
Сву	Спілка визволення України
Святе́ць	святий
Сгд	Союз гетьманців-державників
Се дивили	дивувалися
Се зістали	залишилися
Се сокотити	стерегтися, оберігатися
Сев	цією
Селег	селезень
Семеряга лихая	серм’яга погана, погана верхня одежа з ряднини
Семип’ядний	у сім п’ядей, приблизно коло півтора метра
Сенат	тут вища судово-адміністративна установа в царській Росії
Сендзьо	суддя
Сендзя	суддя
Сервус	приятелювання, панібратство, привітання потиском руки, здоров був, привіт (форма привітання)
Середдорожжя	роздоріжжя
Серенча	щастя
Серсам	інструмент
Сершун	шершень
Сесі	ці
Сестрінець	сестрин син
Си	частка «ся» в дієсловах, собі
Сибі́рковий	смушковий
Сивни́й	рясний (про врожай)
Си́гла	густий ліс, що прилягає до полонини
Сиготіти	тремтіти
Сила треба	скільки треба
Силяжище	шеляг
Силяти	прив’язувати
Сим	цим
Симбр(и́, о́)ля	заробітна платня
Синжапка	мала пляшка горілки (по-турецьки
Синило	синя фарба, синька
Син-лен	синій льон
Синоцвіт	волошка
Синтирува́ти	провести новобранця через медичну комісію, взяти на військову комісію
Сипжапа	мала пляшка горілки (по-турецьки
Сирба	румунський танець
Сириця	сиром’ятна, недовироблена шкіра
Сировець	тут брага для пива
Сировий	сирий
Сирохман	бідняк, бідолаха; сирота
Сівба	зібраний урожай
Сійчас	зараз
Сікатися	шукати паразитів на голові у когось
Сікори	осокори
Сімйою	сім’єю
Сімня	сім’я
Сірки	сірники
Сіром’яга	бідна верхня одежа, серм’яга
Сірома	голота, біднота
Сіроманець	вовк
Сіромаха	голота, біднота
Сірячина	сіряк, верхня одежа з валяного овечого сукна домашнього виробництва
Сітинати	рубати
Січас	зараз
Січовики	тут жителі Запорозької Січі, запорозькі козаки
Сказитися	побитися, поламатися, розбитися (про посудину абощо)
Скала́	крутий схил гори
Скалля	тріски, скалки
Скалубина	тріщина
Ска́меніти	скам’яніти
Скамниця	лава; тут склеп, магазин
Скапа́ти	уникнути чогось небажаного, врятуватися
Скарбовий	державний, казенний; тут робітник у склепах поміщицького маєтку
Скарбонка	скринька
Скарідуватися	бридитися
Скельтовац	зужиткувати, витратити
Скільтувати	витратити
Скіпчіти	загуснути
Скіра	шкіра
Скірні	чоботи
Скітити	знищити
Скіць	скік
Склеп	крамниця
Склепар	крамар
Склецок	клунок з зерном або борошном
Скляничка	пляшечка
Скля́нка	пляшка
Склянчина	пляшечка
Скобитати	лоскотати
Скоблина	скалка, тріска
Скоботати	лоскотати
Сковдошіти	перетворитися на жебрака
Скопець	дерев’яна дійниця
Скорбутатися	перекотитися через голову
Скореньки	чоботи
Скором	скоромна їжа тваринного походження, яку віряни не їдять у піст
Скорух	горобина
Скочка	лісова мишка
Скочуся	лісова мишка
Скра́клі	гра в кеглі
Скрепі́ття	нетрі
Скрипиця	колодка, дерев’яні кайдани
Скрипниця	колодка, дерев’яні кайдани
Скру́шитися	розлютитися
Скуботати	лоскотати
Скузіка́тися	кинутися в сварку
Скура	шкіра
Скусити	спокусити
Ску́тати	знищити ворога
Скушно	нудно
Слабови́тий	хворобливий
Слєдующий	наступний
Сли	чи, чи чуєте
Слихати	чути
Сличний	чудовий
Слуп	стовп, стовпчик
Слупець	стовп, стовпчик
Случай	випадок
Слюб	шлюб
Смаженя	ячниця на молоці
Смекалка	винахідливість, розум
Смерти сте’м не виділи	смерті ви моєї не бачили
Смієлиси	сміялися
Сміттяни́й	нікчемний
Смолош	сопляк
Смот	дивись
Смотрити	дивитись
Смутно	сумно
Снияла	снила, тліла
Сно́чі	вчора увечері
Снять	їжа
Со	із
Собивати	збивати ноги, руки, калічити
Совєтувати	радити
Согласитися	погодитися
Содома	гамір, крик, метушня
Сой	собі, себе
Сокота́ч	сторож
Сокотити ся	оберігатися, остерігатися
Сокоти́ти(ся)	стерегти(ся), берегти(ся), сторожувати, вартувати, стерегти, пильнувати, оберігати
Сокоти́ти(ся) виду	вважати, щоб не потрапити на очі
Сокотить	стерегти
Соломаха	їжа з рідкого тіста; тут бідна їжа з рідкого житнього тіста, звареного на солоній воді без будь-якого жиру
Солони́на	свиняче сало
Солтиря	Псалтир
Солтис	сотський; тут сільський староста за часів білопольської окупації Західної України
Сомар	осел
Сомиря	тут замирятися, просити миру
Сомиряти	тут замирятися, просити миру
Сор	розор, погром
Сороківець	срібна монета
Соснова тертиця	соснова дошка
Сотник	командир військового підрозділу, сотні, а також начальник військово-адміністративної і територіальної одиниці, яка входила до складу полку
Соу	Спілка офіцерів України
Соха	примітивний дерев’яний плуг, завезений до нас з Росії
Сохтирія	псалтир
Сохтовати	звикати
Со́ша	вимощена каменем дорога
Спаплюжити	зганьбити
Спасувати	відступити, злякавшись абро збентежившись
Спацир	пішохідна прогулянка
Спацирува́ти	проходжатися, прогулюватися пішки
Спа́цір	пішохідна прогулянка
Спенцерина	пелерина
Сперати	забороняти
Сперти	зупинити
Спильна	пильно, уважно
Спира́ти	зупиняти, спиняти, затримувати
Співанка	коломийка, коломийкова пісня
Спі́ворити	заверещати
Спіж	погріб
Спіжовий	залізний
Спіновий	залізний
Спіш	майстер, що виливає дзвони
Сплєтнічати	пліткувати
Сподарейко	господаронько
Спо́дні	штани
Спомни си	згадай собі
Споневіряти	марнувати
Споришки	порічки
Спортити	зіпсувати
Спра(к, х)тикува́ти	перевірити
Спри́ходу	спочатку, на початку
Спріла	спряла
Спрятати	сховати
Спу́дитися	злякатися
Спу́за	попіл, пил
Спузар	палиця, якою мішають у вогні
Спузяний	запилений, запорошений
Спузяник	попелюх
Спускана на пожарі	знищена, спалена
Сріберний	срібний
Ста́витися	прибувати
Ставні	віконниці
Сталє́нка	сокира з доброї сталі
Стан	стайня
Стандари	порожнина під піччю
Старати	набувати, придбати
Стариня́	батьки
Старця	старчиха, жебрачка
Старшук	старший за становищем серед групи людей
Стація	постій війська за рахунок населення; такі постої польських військ дуже розоряли трудящих; повинність, побори, тягар, зловживання
Стацья	постій війська за рахунок населення; такі постої польських військ дуже розоряли трудящих; повинність, побори, тягар, зловживання
Стая	зграя; пастуша хатина на полонині
Сте	частка в другій особі множини дієслів, ви
Стенвага	частина плуга
Степір’я	молоде пір’я цибулі
Стєгати	стягати, здирати
Сти́гна	літній табір чабанів з вівцями
Стидно	соромно
Стина	літній табір чабанів з вівцями
Стинутися	струснутися
Стиржія	перепалене й обвуглене бадилля
Сти́рта	скирта
Стівка	сотня
Стійка	варта
Стіко	стільки
Стовка	сотня
Стожари (іскри)	тут надзвичайної сили вогонь
Стойка	прилавок на базарі
Столе́ць	стілець
Столи́ця	царський або королівський палац, резиденція монарха
Стонжечка	стрічка
Сторона	засторонок в клубі
Сторошувати	чепурити, прикрашувати
Сторцюва́ти	ставити сторч, поставити сторч
Страба́ччя	гостре каміння
Стражник	нижчий поліцейський чин в сільських місцевостях, підлеглий уряднику
Страпатий	сучкуватий, гіллястий
Стратити	згубити
Страховіття	страховисько
Страхопуд	боягуз
Страшна (хура)	застрахована
Стреби́ти	знищити
Стред, (на) стред	посередині
Стри(к, ко)	дядько, батьків брат
Стрижія	сажа, кіптява, перепалене і обвуглене бадилля
Стрий	дядько, брат батька
Стримбак	скалка
Стрина	тітка, стрикова жінка
Стрих	горище
Стрівбочки	кайдани
Стрі́льба	рушниця
Стріп	дах, склепіння, звід
Стріти	зустріти
Стріх	горище
Стріцовий	страусовий
Стріча	зустріч
Строкар	найнятий на службу
Стром	дерево
Стру́нга	прохід у кошарі, через який пропускають поодинці овець для доїння
Струнка	прохід у кошарі, через який овець пропускають по одній
Струтити	зіпхнути, зіштовхнути
Струхніти	сполошитися, злякатися
Стру́цень	пиріг, плетений колач
Стрьомно	страшно
Стрягнути	скочити
Студе́ний	замерзлий
Студено́	холодно
Студінь	холод
Студничок	криничка, джерело
Сту́дня	керниця, криниця
Стулень	пиріг без начинки
Ступанки	камені для переходу через мілку річку
Ступінь	крок
Стуря́тися	здивуватися
Стьобати	сьорбати
Суб	Союз українців Британії
Суві	Союз українських воєнних інвалідів
Судина	дерев’яні посудини: бочки, цебри, коновки тощо
Судни́к	дерев’яний посуд
Судома	тяжка хвороба, корчі; велике лихо
Судошає	зустрічає
Суз	Східноукраїнські землі
Сукман	сірячина, верхня одежа, кафтан, сукня
Сукманки	верхній одяг
Сулія	велика пляшка
Сулятися	кидатися
Сум	Спілка української молоді
Сундук	скриня
Сунм	Союз української націоналістичної молоді
Суньголов	сторч головою
Супліка	письмова просьба, скарга, звернення, а також лист
Супровіт	старший війт
Сусік	засік
Сусі́ха	кочерга
Сут (є)	є
Сутулівше	зсутулившись
Суть	є (множина)
Су́фіт	стеля
Сух	суша; на сусі —на сухому
Сухарда	сухоребрий кінь
Сухо́ти	туберкульоз
Сушеда	сусід
Суши́ця	всохле дерево
Существо	істота
Схода	зразу
Схоронок	збереження
Схудобніти	збідніти
Ськати	вибирати воші на голові у когось; шукати
Сьмо	є
Ся забавили	затрималися, забарилися
Сяг	міра довжини
Сяно	сіно
Т	до
Т’хаті	додому, до хати
Табала	шкіряна сумка через плече
Табахєрка	коробочка для тютюну
Табі́вка	шкіряна сумка, яку носять через плече
Табла	дошка
Таборик	стільчик, табурет
Таволга	лугова рослина, з стебла якої в старовину робили канчуки і шомполи для рушниць
Таган	палиця, на яку підвішують їжу над вогнем
Тагже	також
Тади	тоді
Тайки	потай
Та́йстра	гуцульська торбина (полотняна сумка), яку носять через плече, торба
Тайстрина	торба через плече
Такой	таки
Таксувати	оцінювати
Тала	назва рослини
Талер	грошова одиниця, старовинна срібна монета
Талір	таріль
Талмуд	товста незрозуміла книга
Таляр	старовинна срібна монета вартістю 75 коп
Тамбор	барабан
Танджер	тарілка
Танір	тарілка
Тано	дешево
Танший	менший, дешевший
Тара	вокзал, станція
Тарабан	барабан
Тарель	талер
Та́рниця	дерев’яне сідло
Тась я затаїла	приховала собі
Татка	портфель, папка
Та́тош (тато́ша)	казковий (чарівний) кінь з крилами
Та́ця	піднос
Тача́вка	валок для розкочування тіста; качалка
Тачівка	качалка
Ташка	портфель, сумка з мідними ґудзиками, шкіряна сумка
Тв	Тактичний відтинок
Твар	лице
Те	тебе
Теліяни	італійці
Теметів	цвинтар, кладовище
Теміт(ьо, ю)в	кладовище
Те́мний	сліпий, незрячий
Те́мник	темниця для ув’язнення
Тен	той
Тенґериця	кукурудза
Тенґеричаний	кукурудзяний
Теньгий	великий і сильний
Теньго	сильно
Те́ньґий (те́ньгий)	гладкий і сильний
Тепли́чка	тепле джерело
Тепша	бляшане деко для випікання хлібів, пирогів тощо
Тераз	нині, тепер, зараз
Теребити	рити кігтями
Те́рлиця	пристрій для вибивання волокна (прядива) з сухої соломки льону або конопель, терниця, пристрій для вибивання волокна з сухих стебел льону й конопель
Термін	повістка; судова справа
Терниця	пристрій для вибивання волокна з сухих стебел льону й конопель
Терті́ла	вантаж, мішок з вантажем на плечах
Терх	в’юк, вантаж, який перевозять на спині коня; навантажені бесаги, перекинуті на два боки через верхового коня
Тестаме́нт	письмовий заповіт, заповіт
Те́та	тітка
Течка	портфель, папка
Тєжко	тяжко
Тє́кнути	вколоти; вразити несподіванкою
Ти	тобі
Тикати	зачіпати
Тили́нка	сопілка з вербової кори
Тильо	тільки
Тиляги	старовинна захисна одежа, лати із залізних або інших металевих пластинок; тиляги вживалися замість кольчуг
Тирон	бригадир на лісорозробках
Тис	особлива порода хвойного дерева, яке відзначається міцністю і довговічністю; тис іде на спорудження кораблів
Тисова лавка	лава з тису
Титар	церковний староста, ктитор
Титарь	церковний староста, ктитор
Титюрка	перепілка
Ті	тобі, тебе
Тівко	стільки
Тік	місце для молотьби; місце для боротьби
Тіки	тільки
Тілько	стільки
Тіта	тітка
Тломити	поїдати
Тлумити	товкти, душити, поїдати
Тлуста	жирна, товста
Тлустий	гладкий, товстий
То́вар	велика рогата худоба, худоба
Товариство кревне і сердечне	нерозривне братство, тісно згуртоване товариство; щирі друзі
Товди	тоді, того часу, в той час
Товпуга	шмат
Товчка	ступа
Тогід	торік
Тогідний	торішній
Тоди	тоді
Токан	хлібний продукт з кукурудзяного борошна (інакше кулеша, мамалиґа)
Токма	тільки
Толок	товкач
Толо́ка	поле, що служить пасовищем; безоплатна гуртова допомога працею
Толочи́ти	товкти, товктися
Толочка	пасовисько
Тоня	помістя, велике господарство
Топанки	туфлі, взуття, черевики
Топір	палиця з металевим топірцем замість рукоятки
Топірець	палиця з металевим топірцем замість рукоятки
То́ргнути	смикнути
Торкати	тихо стукати
Торомба	губа
Тось	ти
Тот	вказівний займенник той
Тота́	вказівний займенник та, вона сама
Тоти́	вказівний займенник ті
Тоти́х	вказівний займенник тих
Тоті́	вказівний займенник ті
Тото́	вказівний займенник те, оце
Тотош	чарівний кінь
Точити	котити
Точок	пристрій в косаря, в якому лежить брусок для гостріння коси
Траба	треба, потрібно
Трайбувати	тут: приводити в рух
Трайста	торба
Трайстра	писана торба через плече
Трап	швидкий біг
Трапениця	страдниця
Трапити	спішити, поспішати
Трастівка	тонка паличка
Трат	тирса
Трафити	потрапити
Трафіка	тютюнова крамничка
Трафни́й	грішний, нечистий
Трачина	тирса при розпилюванні дерева
Тре́вка	дерев’яна цеберка
Трен	поїзд
Трепе́та	тополя
Трепіть	тремтіти
Третячо́к	трирічний
Тринзелька	гнуздечка
Триння	потерть, подрібнена солома
Трібувати	пробувати
Трійло	отрута
Тріло	отрута
Трінкбехер	келих
Троєний	затруєний
Троцька пила	пила для пиляння дощок
Тро́ща	очерет, вітки
Трудни́й	втомлений, стомлений, змучений, натруджений
Труйка	отрута
Трумбета	труба, трембіта
Трумна	труна
Трумно	труна
Трумфувати	травмувати
Трунва	труна, домовина
Тру́но	труна, домовина
Трунок	спиртний напій; шлунок,
Тру́тити	штовхнути, пхнути, спихнути, кинути
Трутка	отрута
Труча́ти	штовхати поперед себе; спихати; кидати
Трюшком	бігом
Трясачка	трясовина
Ту	тут
Туб	сувій
Тузлук	розчин кухонної солі для соління чого-небудь; тут дуже солона переварена вода
Туй	тут
Тули́ти	вабити, приваблювати
Туля	частина одягу священика
Туля́тися	торкатися
Тума́	неговірка людина, людина мішаної породи, – один з родителів турчин або татарин, а другий українець
Тумаки	штовхани
Тумок	клунок
Турас	турчин
Ту́рма	отара, вежа
Турна	вежа
Турня	вежа
Турський	турецький
Турша	зарості дрібних смерічок і ялиць
Туск	туга
Тускувати	сумувати
Тусок	туга
Тучний	гладкий, вгодований
Тушний	гладкий
Тюре́мник	в’язень
Тюрок	свисток-сюрчок
Тюря	хліб з квасом
Тя	тебе
Тягота́	вагітність
Тяготи	вагітність
Тяжка	вагітна
У предмету	для прикмети, на прикмету
У самому хмелю бував	був дуже п’яний
Убезпечати	застерігати, завіряти
Убоча	луг
Убува́ти	взувати
Убуркувати	укласти камінь у брук
Убути	узути
Ув’яда́ти	завмирати (з переляку, від захоплення, тривоги і т. ін.), упадати на силах
Ув’я́нути	втомитись, знесиліти, зімліти, знепритомніти
Увв	Українське визвольне військо (Німеччина)
Увидіти	побачити
Увиха́тися	дуже швидко щось робити, квапитись із роботою, встигати, справлятися
Увіритися	набриднути
Уво	Українська військова організація
Увф	Український визвольний фонд
Уга	Українська галицька армія
Угашу йому (їй) нема	спину йому (їй) нема, не спинити його (її)
Угвр	Українська головна визвольна рада
Угібати	ловити
Угорнутися	одягти на себе верхній одяг
Уго́ртина	верхній одяг
Угр	міра площі (0,57 га)
Удивитися	здивуватися
Удобний	достойний, той, хто придатний саме для певної справи
Удп	Українське державне правління (оголосило відродження Української самостійної держави)
Уздріти	побачити
Узлостило	розізлило
Уйош	піджак із домотканого сукна
Ука	лука
Укка	Український конгресовий комітет Америки
Уконтентуватися	задовольнитися
Укср	Українська крайова студентська рада
Улани	легка кіннота
Улапіла	впіймала
Улий	вулик
Улія	олія
Улоги	рівне поле
Уложити	укласти
Улус	татрське село у Криму
Умрази́ти	образити, спаплюжити
Умшля́к	компрес
Ун	він
Уна	Українська національна армія (Німеччина)
Унв	Українське національне відродження
Унгар	угорець, мадьяр
Унгарський	угорський
Ундо	Українське національно-демократичне об’єднання
Ундс	Український національно-демократичний союз
Унну	всередину
Уногди	цими днями
Унпо	Українська національна повстанська організація
Унр	Українська народна республіка, Українська національна рада
Унра	Українська народна революційна армія (нова назва УПА Г. Бульби-Боровця від липня 1943 р.)
Унс	Українська народна самооборона
Унтир	підлеглий
Унф	Український національний фронт
Уп’ять	знову
Упа	Українська повстанська армія
Упадеться	попаде до рук
Упомни	запам’ятай
Ураз	разом
Урваш	сильний, міцний чоловік
Урдп	Українська революційно-демократична партія
Урєд	місцева влада, повітова влада
Уривок	мотузок, вірьовка
Урікати	докоряти
Урльо́п	відпустка (з армії)
Уроже́ний	з урожаю
Урпо	Українська революційна повстанська організація
Урфій	панич
У́ряд	управа (установа)
Усдрп	Українська соціал-демократична революційна партія
Усидок	садиба
Услонити	приспати (дитину)
Услужалий	слуга, прислужник
Усовіщати	навчати
Уссд	Українська самостійна соборна держава, Українська суверенна соборна держава
Усст	Українське студентське спортивне товариство
Устарати	придбати
Уталюва́ти	вміщати
Утворений	відчинений
Утвори́ти	відчинити
Утяти	вирубати
Ухлюпа́ти	слабнути, втрачати сили
Ухри́нути	опритомніти
Уцекати	втікати
Учар	вівчар, пастух
Учаречка	пастушка
Учини́тися	опинитися; народитися
Учі́пний	причетний
Учка	лучка (луг)
Учутися	виявитися
Ушкала	річкові розбійники; тут турецько-татарські загарбники
Ушкали	річкові розбійники; тут турецько-татарські загарбники
Ущербитися	всмоктатися в землю
Файда	нагайка
Файдиґа	добра справа
Файка	гуцульська люлька
Файна	гарна, красива
Фа́йний	гарний
Фа́йно	гарно, красиво, добре
Фаланда	фелон
Фалат	кусень, шматок
Фалечний	впертий
Фало́н	фелон, верхнє вбрання священика, яке вдягається під час богослужіння
Фаля	хвиля
Фамі́лія	рідня, родина, прізвище
Фамілія́нт	родич
Фа́на	прапор
Фанда	гарапник, довгий батіг
Фантинка	одежинка
Фантува́ти	описувати майно за несплату податків
Фара	попівська оселя, попівське обійстя
Фарадшаг	втома
Фарма	ферма
Фаснути	вдарити
Фасувати	1) припасовувати; 2) бідувати, мучитись
Фасуля	квасоля
Фатка	сітка з держаком для ловлі риби
Фафурига	тут поліцейський, городовий
Фаши́ння	гілля, пруття, хмиз
Феделка	покришка від посудини; скальп
Федерина	пелерина
Фейт	вантаж, вантажний поїзд
Феле́ґа	драна свитина
Ферталь	чверть
Фертик	кінець (якогось заняття)
Ферфляша	баклага
Фест	твердо; багато; сильно; дуже добре
Фестунг	фортеця
Фесту́нок	укріплення; святкування
Феци	онучі (до чобіт)
Фийшер	офіціант
Фівкало	свисток
Фі́вкнути	свиснути
Фіглі	жарти
Фіґльовати	жартувати
Філин	хрещеник
Філіжанка	кружка, горня, чашка
Філон	вбрання священика
Фільва́рок	землевласницький маєток, панське господарство з будівлями, худобою й полями
Фін	хрещеник
Фінанс	фінагент
Фінок	хрещеник
Фі́ра	віз
Фі́рман	візник, кучер
Фірма́нка	поїздка кіньми
Фіртка	хвіртка
Фіфак	несерйозний і хвалькуватий парубок
Фіякер	візок для перевезення пасажирів у містах
Фія́кір	бричка, візницька карета
Флє́шка	пляшка
Флінта	рушниця
Флоє́рка	сопілка
Фляки	перемиті свинячі кишки
Фляшченя	пляшечка
Фнє	Фронт національної Європи
Форгова	постать
Фо́рин	головний
Форналь	наймит до коней і худоби
Форост	хмиз
Форси	гроші
Фортні, форинти	угорські гроші
Форточка	кватирка для провітрювання
Фо́са	рівчак, канава, шанець, придорожній рів
Фоштер	лісник
Фоя	хвоя
Фраєр	коханець
Фраїр	хлопець, коханий, парубок, жених, милий, коханець
Фраїречка	любка
Фраїрка	дівчина, кохана
Фраїрочка	дівчина, кохана
Фрай мати	бути вільним
Фрайвіліх	добровільно
Фрас	чорт, чорт би тебе побрав, лайливе слово
Фрасуватися	тривожитися
Фрасунок	журба, клопіт
Фраюрочка	дівчина, кохана
Фрела	сопілка
Фризиєрня	перукарня
Фризіє́р	перукар
Фришно	скоро
Фриштик	сніданок
Фриштих	сніданок
Фрізіє́р	перукар
Фрілка	сопілка
Фузія	рушниця
Фукати	кричати, гукати
Фунт	міра ваги, 400 грамів
Фурдіти	гудіти
Фурман	візник
Фурнути	жбурнути
Фурт	постійно, завжди, весь час
Футро	шуба
Футрувати	годувати (тварин)
Фучит	хропить
Фуярка	один з видів сопілки
Фуярош	той, що виготовляє сопілку, сопілкар
Халазія	лупцювання
Халат	тут: шинель
Хала́ш	курінь
Харапу́тно	негарно, непривабливо
Харашо	добре
Хаща	ліс
Хвайда	нагайка
Хвестува́тися	неприязно перемовлятися
Хвойда	хворостина
Хвойдина	хворостина
Хвор	хвороба
Хворост	хмиз
Хибити	бракувати, не вистачати
Хижа	хата
Хиріти	без пуття спати; хворіти
Хитрити	вистежувати
Хіба	тільки, лиш
Хіни	китайці
Хісно	пожиток, користь
Хіснува́ти	бути корисним
Хладок	холодок
Хлівонька	кривавиця
Хло’	циганська фамільярна форма звертання, хлопці, люди
Хлоп	чоловік, простий селянин, сільський дядько
Хлопок	тут джура, а також слуга з кріпаків
Хльо	фамільярне звертання у циган
Ховзко	слизько
Ходак	постіл
Хоже́ний	бувалий
Холиво	хованки (гра)
Холод	холодок, затінок у спеку
Холодна	погріб у селі для короткочасного ув’язнення
Холозія	частування
Холошні	домоткані штани
Хопта	трав’яниста бузина; бур’ян; різні дрібні створіння
Хорі́мний	сіне́шний (від сіни)
Хорми	форми
Хоро́ми	сіни
Хорти	мисливські собаки
Хорува́ти	хворіти
Хорунжий	чин у козацьких військах, а також прапороносець
Хосен	пожиток, користь
Хоснувати	мати пожиток
Хотар	межа між землями двох сусідніх сіл, лани, луки, поля
Хоць	хоч, хоча
Храм	храмове свято
Хра́мати	кульгати
Хрестити	бити
Хромати	кульгати
Хромий	кривий на ногу
Хронт	фронт
Хрунавий	кволий, хирлявий
Хрунь	запроданець, людина без совісті
Хтовди	тоді
Хторий	котрий
Худоба	достатки, рухоме майно, в тому числі худоба
Худобний	бідний, убогий
Хужіший	гірший
Хупавий	гарний, нарядний
Хуста	білизна, одяг
Хце	хоче
Хцеш	хочеш
Хцяв	хотів
Цайґовий одяг	дешевий бавовняний одяг
Цап	козли для пиляння дров
Цапіна	знаряддя для перекачування колод
Цапки	на диби, рачки
Цари́знина	царство
Ца́рина	ділянка, сінокісні поля, засіяне поле; тут огорожене від поля місце, вигін, а також місце для випасу худоби
Ца́ринка	галявинка
Цариночка	засіяне поле; тут огорожене від поля місце, вигін, а також місце для випасу худоби
Царок	місцина
Цвек	цвях
Цвіток	квітка
Цвітом процвітана галера	галера, розмальована різнокольоровими яскравими фарбами
Цебеніти	литися
Цебер	деревяна посудина для худоби
Цежко	тяжко
Цемерка	кімнатка
Цен	тінь
Цент	тут американська дрібна монета, сота частина долара
Цепочок	ланцюжок
Церк(і, о)вник	паламар
Цес	цей
Ци	чи
Циба!	вигук, яким відганяють собак
Цибати	стрибати
Цибух	люлька
Циду́лка	записка
Цижми	чоботи, черевики, взуття; тут грубе взуття
Циліндер	скло гасової лямпи
Цимбора	товариш, друг
Цимбра	кімната
Цині́вка	металева посудина для пиття води, металева кварточка, горнятко для пиття води
Циркул	округа, волость
Цирульня	перукарня
Цирюльник	перукар
Цисе	це
Цисей	цей
Цися	ця
Ціжми	чоботи, черевики, взуття
Ціка́вий	працьовитий, справний, енергійний
Цімбора	товариш
Цімборик	товариш
Цімра	кімната
Цімря	палата, кімната
Цінькати	робити характерні рухи ножицями або пальцями, як ножицями
Цісар	австрійський імператор
Ціхо	тихо
Цминтар	кладовище
Цмок	змій
Цнути	тужити
Цопкати	падати частинами
Цоркати	стукати, брязкати
Цофнути	податися назад
Цофну́тися	податися назад
Цуг	поїзд
Цуга	тяглова сила
Цуґнутися	податися назад, відсахнутися
Цунделі	дрантя
Цур’я	дрантя
Цуравий	подертий, обдертий
Цурі́кнутися	податися назад
Цуромки	суремки, військові сурми, труби
Цуцлик	соска
Цьоця	тітонька
Цюндравий	обдертий
Цюра	козацький слуга, помічник, товариш, довірена особа військового керівника, джура
Цятки	намисто
Чабак	лящ
Чабанії	породисті воли, якими чумаки їздили в Крим
Чавун	баняк
Чаву́нка	залізні листи для обшивки
Чагунка	залізниця
Чака, чако	каска
Чаплея або чаплія	пристрій, яким витягали горшки з печі
Чар	сковорідка
Чари	отрута
Чародія	чарівниця
Чеберяти	танцювати, пританцьовувати
Челлений	червоний
Челядина	дівчина
Челядь	члени сім’ї, жінки й дівчата
Чемайдан	валіза
Чемний	чесний, порядний, добрий (про людину)
Чепрага	сідло
Червени	червоні
Черво́ний	червінець, золота монета
Червоний золотий	червінець, монета з чистого золота
Чердак	тут капітанський місток
Черепіти	деренчати
Черес	широкий шкіряний пояс, в якому можуть носити гроші
Чересок	черес, широкий подвійний шкіряний пояс, в якому раніше носили металеві гроші
Черешок	черес, широкий подвійний шкіряний пояс, в якому раніше носили металеві гроші
Черкелесенький кізочок	тут козел в отарі овець
Черлений	червоний
Черницев зілляти	залити мазутою, дьогтем
Черчата	пофарбована в червець
Черчик	монах; тут — гарний, красивий; червець (рослина з квітами червоного кольору)
Черяти	черпати
Чесом	часом
Честовати	шанувати
Честоватися	шанувати один одного
Честь	частина
Четина	хвоя
Чечень	тут козак-чеченець
Чижмаки	чоботи
Чижми	чоботи, черевики, взуття
Чик	сорокопуд
Чикчири	кавалерійські штани
Чини́тися	удавати
Чиншові селяни	селяни, які користувалися земельними угіддями поміщика, за що сплачували йому регулярний податок (чинш, оброк). З посиленням феодальної експлуатації більшість таких селян ставала кріпаками
Чиняй	відчиняй
Чир	бідняцька страва із завареного (запареного) нагусто борошна, рідка їжа з кукурудзяної муки
Чиряти	зачерпувати, черпати
Чистина	галявина
Чіжми	чоботи, взуття
Чіпкар	мандрівний крамар
Чісар	цісар
Чічка	квітка
Чмовхалка	пристрій для розчісування вовни
Чобанистенькі	великі, крупні
Чокан	кирка
Чоканува́ти	розбивати щось чоканом (киркою)
Чоло́ пенька	переріз пенька
Чоло́ни	бруски, з яких монтувався обід колеса для воза
Чопе́ць	пристрій, який прикріплювали до взуття лісоруби, щоб ноги не ковзали по колодах
Чорниці	ягоди ожини
Чубаритися	чубитися, не миритися між собою
Чубарочка	козацький оселедець на голові
Чувал	мішок
Чугай	свита, верхня одежина з домотканого сукна, хлопець
Чуга-чуганя	накидка, чоловічий одяг
Чуги	верхня чоловіча одежа в Прикарпатті; шерстяна накидка, вид свитки без рукавів
Чугунець	банячок
Чуда	поміст на судні, капітанський місток
Чудува́тися	дивуватись
Чужениця	чужий, нерідний, іноземець
Чулан	комірчина
Чулка	волосся
Чундравий	обдертий
Чуні	калоші, склеєні з автомобільної камери
Чупає	відмова на право перебування в даній місцевості
Чупер	чуприна, чуб
Чу́пир	чуприна, волосся на голові
Чура	козацький слуга, помічник, товариш, довірена особа військового керівника, джура
Чурі́ти	текти
Чуркальце	облашто́ване джерело води; жолобок для витікання води
Чурупіта	пташка-посмітюшка
Чуфли́нок	залізний клин з кільцем, пристрій для спускання дерев’яних колод з гори по снігу
Ш(и́, і́)фа	корабель
Ш(и, і)фкапітан	капітан корабля
Ш(и, і)фка́рта	проїзний квиток на корабель
Шабату́ра	сумка для грошей, великий гаманець
Шаг	гріш, дрібна розмінна монета, вартістю півкопійки; крок
Шажок	гріш, 1/2 копійки
Ша́йба	мішень
Шайні	почесні
Шайнути	дунути
Шак	адже, тому
Шал	шум
Шалата	салата (городина)
Шалина	зарості
Шало́к	хустка
Шанда́р	жандарм
Шандер	жандарм
Шани	канава, кювет
Шанкрувати	розбивати
Шантала́вий	обдертий
Ша́нці	рови з насипом, земляні укріплення, окопи
Шапка-бирка	шапка з овечого смушка
Шапка-вергирка	шапка-венгерка
Шапков гачі латав	шапкою штани латав
Шарабан	двоколісний віз з коробкою для сидіння
Шарахван	шинель
Шарварок	примусова робота на пана; тут робота на панському дворі, а також податок у панській Польщі на утримання доріг
Шаркан	в’юга
Шаркан(ь)	химера-змій
Шаркантьови	шпори
Шарлота	голота, біднота
Шарло́тт(а, я)	голота, біднота
Шаронка	шеренга, ряд
Ша́тан	<a href="https://proridne.net/Українська міфологія/Чорт.html">чорт</a>
Шати	одяг, багата верхня одежа, риза
Шатро́	розцяцькована попона
Шаття	одяг
Шацува́ти	оцінювати
Шваб	німець
Шваблик	сірник
Шва́ґер	брат дружини, чоловік сестри
Швайка	товсте шило
Швак	лясь!
Шванка	мотузка
Шварна	моторна, жвава
Шварц	контрабанда, нелегальна торгівля
Швет	світ
Ше	ще
Ше днесь	ще сьогодні
Шевелитися	ворушитися
Шелеснатий	густо вкритий листям
Шеліґура	кий
Шельвах	варта
Шембарок	кухонна шафа
Шендер	жандарм
Шеретувати	перед помолом обдирати лузгу з зерна
Шестри	сестри
Шибати	кидати, гойдати
Ши́блик	сучок на остріві
Шиківати	готувати
Шиковно	жваво
Шикувати	готувати
Шиньк	шинок
Шипка-вирганка	шапка-венгерка
Ширина	хустка
Ширинка	хустка, тут: манишка
Ширінка	платок
Ширіночка	хустиночка
Шиф	корабель, пароплав
Шифа	корабель, пароплав
Шифкарта	квиток на пароплав
Шифон	шафа
Шицки	усі
Шицко	усе
Ші	ще
Шідзем	сім
Шіковний	спритний, моторний
Шільд	вивіска (з нім.)
Ші́нка	зав’язка на сорочці
Шіпка	шапка
Шіпок	корж
Шіто	сито
Шітькати	підкидати вгору
Шіфа	корабель, пароплав
Шкадрона	ескадрон
Шкалу́бина	дірка в деревині на тому місці, де випав сучок
Шкаму́тки	клапті
Шкату́ла	гаман для грошей
Шкідний	шкідливий
Шкорух	горобина
Шкр....	недогарки, від яких ще димом чути
Шкребта́ти	бігти
Шкрі́нькати	бряжчати
Шкрум	рештки перегорілого, запах перегорілого
Шкрумі́ти	горіти, вуглитися
Шлик	рід головного убору; тут висока смушева шапка з довгим суконним верхом, який іноді закінчується китицею; в думі — з бархату
Шличок	рід головного убору; тут висока смушева шапка з довгим суконним верхом, який іноді закінчується китицею; в думі — з бархату
Шлієще	шлеї
Шліхтувати	загладжувати тканину завареним крохмалем
Шлюс	кінець, завершення будь-якої дії
Шлякувати	лаяти
Шлямпац	марширування
Шлях би тебе трафив	лайка, побажання наглої смерти
Шлях би трафив	лайка, побажання наглої смерті
Шляхувати	лаяти: «шлях би тебе трафив»
Шмарити	викидати
Шмат	одяг, шмаття
Шматок	ганчірка
Шма́ття	одяг
Шмір	мастило до воза або до чогось іншого
Шнайса	просіка
Шнельфаєр	автоматична зброя
Шнур	ряд
Шнюпати	тюпати
Шо	що
Шовгур	шваґер, шуряк
Шовдар	свиняча шинка, окіст, нудженина
Шоля	підйомник, ліфт
Шопа	хлів з двома або трьома стінами для возів та господарчих речей
Шо́па, шопка	невелика господарська будівля для зберігання різного реманенту та дров, повітка, сарай
Шор	черга, ряд
Шорох	шелест
Шостак	дрібна монета в три копійки, шість грошів
Шпарґа	шпагат
Шпаркий	швидкий, бистрий;економний
Шпарко	швидко
Шпарувати	складати, заощаджувати гроші
Шпа́цір	пішохідна прогулянка
Шпацірувати	прогулюватися
Шперувати	складати, заощаджувати гроші
Шпихлір	комора для зерна
Шпіклі́р	будинок-комора
Шпорна	шпори
Шпурити	жбурнути
Шрам	шмат
Шру́бка	гайка
Шрубок	шруб; тут пробка для пляшки з різьбою
Шрубстак	лещата
Штає́ра	галопом
Штама	стовбур, стовп
Штамплик	рюмка
Штанд(а́, е́)́ри	ніша під піччю, місце під піччю, куди клали дрова
Штандари	місце на дошках під піччю
Штанціон	залізнична станція
Штація	станція
Штверці	шлея, пристосування для перенесення великого вантажу однією людиною
Штемплик	п’ятдесятиграмова чарка
Штигулькати	шкутильгати
Штимува́ти	пасувати, підходити
Шти́ри	чотири
Штирі та бирі	тут назва овець
Штих	на глибину лопати
Што	що
Што мат	що має
Шток	поверх; палиця (нім.)
Штокгавз	тут: гауптвахта, карцер
Што́лі	шипи на кінських підковах
Штоф	чотиригранна пляшка для горілки
Штрамува́тися	святково одягатися
Штред, (на) штред	посередині
Штрика́ти	стрибати, скакати, кидатися
Штрімфля	панчоха
Штровгаз	тут: гауптвахта, карцер
Штромацько (вбратися)	підкреслено гарно і модно
Штуб	порохнявий стовбур
Штудер	штукар-хитрун
Штудерува́ти	хитрувати, мудрувати, муштрувати
Штука	тут: шматок поля
Шувний	гарний
Шугай	парубок, хлопець
Шугайці	парубки
Шудло	протез замість ноги
Шудра	незаконна жінка
Шудратий	кучерявий; прикметник від: шудра
Шук	міра довжини, довжина великого пальця на руці
Шу́ляк	шуліка, яструб
Шумелина	бадилля
Шумили́ння	листя, в яке загорнений качан кукурудзи
Шумний	гарний, пишний, буйний
Шу́ра	господарська прибудова
Шустер	швець
Шустрик	шевчик
Шуте́р	щебінь
Шутонька	вівця
Шутрований	всипаний шутром або щебенем
Шуфе́лька	совок
Шу́фля	совкова лопата
Шух	штабель дров об’ємом один кубометр
Шу́хи	складометри дров
Шу́ховий	узятий зі шуха
Щас	зараз
Ще ’сь	ти ще
Ще́зби	<a href="https://proridne.net/Українська міфологія/Чорт.html">чорт</a>
Щезлий	<a href="https://proridne.net/Українська міфологія/Чорт.html">чорт</a>
Щезник	<a href="https://proridne.net/Українська міфологія/Чорт.html">чорт</a>
Щирозлотий	з чистого золота
Щіборіщі вівці	вівці з відбитими рогами
Щіпка	тріска
Що муть волю ймити	що матимуть волю
Щомо́га	щосили
Ю	її (знахідний відмінок)
Югас	вівчар, пастух
Юда	незгода, сварка
Юдити	підбурювати до чогось поганого
Ю́дство	підбурювання до незгоди і розбрату
Юж	вже
Юлка	вулиця
Юрки	кілочки, які використовують при в’язанні снопів
Юркнути	миттєво сховатися
Юрком в’язати	в’язати снопи за допомогою юрка, спеціального дерев’яного кілочка
Ютро	завтра
Я йсем друтар	я той, хто зв’язує дротом
Ябка	яблука
Ябко	яблуко
Яв	взяв
Яв ся	взяв, став
Ядловець	ялівець
Язя	змія
Як з татарки паска	іронічно: як паска з татарського зілля
Якнайживше	якнайшвидше
Яко влони	торік
Якурат	якраз
Яла	взяли
Яли	взяли, стали
Ялівка	телиця
Яничари	привілейовані піхотні війська в султанській Туреччині, які використовувалися для каральних операцій; відзначалися особливою жорстокістю
Яниченьки	привілейовані піхотні війська в султанській Туреччині, які використовувалися для каральних операцій; відзначалися особливою жорстокістю
Яприна	аґрус
Яр	весна
Яра бджола	рання, весняна бджола
Яречок	ярок
Яриза	ярига, нижчий військовий, поліцейський служитель; тут перекладач
Ярий	весняний
Ярий віск	білий віск, від ранніх взяток бджіл
Ярманок	ярмарок
Ярмолок	ярмарок
Яровати	займатися весняною сівбою
Ярч(а, я)	ягня
Ярь	займатися весняною сівбою
Яса	галас, шум, а також салют, привітання гарматними пострілами
Ясина	галас, крик, тривога
Ясир	полон, здобич, яка складалася з населення, взятого в неволю, а також неволя, рабство
Ятрівка	невістка
Яфини	чорниці
Ячати	кричати по-лебединому, кричати, шуміти
Ячити	кричати по-лебединому, кричати, шуміти
Яшний	ячмінний
